year,region,country,permanent,temporary,irregular ,total,new_hires_2003,new_hires_2012
2000,World,World Total,2551549,2991125,1840448,7383122,-,-
2000,Africa,Africa Total,269,22024,9718,32011,-,-
2000,Africa,Egypt,53,850,1000,1903,-,-
2000,Africa,Libya,75,4300,500,4875,-,-
2000,Africa,Others or Unspecified,141,16874,8218,25233,-,-
2000,East and South Asia,East and South Asia Total,64214,922283,734347,1720844,-,-
2000,East and South Asia,Brunei,26,22657,738,23421,-,-
2000,East and South Asia,Hong Kong,404,148844,500,149748,-,-
2000,East and South Asia,Japan,59626,133631,16369,209626,-,-
2000,East and South Asia,South Korea,1448,10312,15273,27033,-,-
2000,East and South Asia,Malaysia,309,85118,509564,594991,-,-
2000,East and South Asia,Singapore,152,54555,65000,119707,-,-
2000,East and South Asia,Taiwan,1853,114926,4300,121079,-,-
2000,East and South Asia,Others or Unspecified,396,352240,122603,475239,-,-
2000,West Asia,West Asia Total,999,1114580,108062,1223641,-,-
2000,West Asia,Bahrain,61,21000,4000,25061,-,-
2000,West Asia,Israel,41,9439,20711,30191,-,-
2000,West Asia,Kuwait,90,35000,15000,50090,-,-
2000,West Asia,Lebanon,19,16495,2000,18514,-,-
2000,West Asia,Oman,18,24834,1500,26352,-,-
2000,West Asia,Qatar,13,32000,1000,33013,-,-
2000,West Asia,Saudi Arabia,234,829300,25700,855234,-,-
2000,West Asia,United Arab Emirates,352,103782,20000,124134,-,-
2000,West Asia,Others or Unspecified,171,42730,18151,61052,-,-
2000,Europe,Europe Total,147408,446632,207995,802035,-,-
2000,Europe,Austria,3166,1156,2000,6322,-,-
2000,Europe,France,865,4685,18050,23600,-,-
2000,Europe,Germany,32497,751,5000,38248,-,-
2000,Europe,Greece,84,33691,37527,71302,-,-
2000,Europe,Italy,1608,65861,62531,130000,-,-
2000,Europe,Netherlands,12208,717,3000,15925,-,-
2000,Europe,Spain ,33979,3113,4000,41092,-,-
2000,Europe,Switzerland,626,5933,9847,16406,-,-
2000,Europe,United Kingdom,45713,5450,2500,53663,-,-
2000,Europe,Others or Unspecified,16662,325275,63540,405477,-,-
2000,Americas or Trust Territories ,Americas or Trust Territories Total,2120708,252648,764200,3137556,-,-
2000,Americas or Trust Territories ,Canada,277744,27550,5200,310494,-,-
2000,Americas or Trust Territories ,United States,1804288,59767,278000,2142055,-,-
2000,Americas or Trust Territories ,Commonwealth of the Northern Mariana Islands,79,20000,500,20579,-,-
2000,Americas or Trust Territories ,Guam,38319,753,2000,41072,-,-
2000,Americas or Trust Territories ,Others or Unspecified,278,144578,478500,623356,-,-
2000,Oceania,Oceania Total,217951,34634,16126,268711,-,-
2000,Oceania,Australia,202110,660,2000,204770,-,-
2000,Oceania,New Zealand,15761,179,100,16040,-,-
2000,Oceania,Papua New Guinea,63,1474,4526,6063,-,-
2000,Oceania,Others or Unspecified,17,32321,9500,41838,-,-
2000,Seabased Workers,Seabased Workers,-,198324,-,198324,-,-
2001,World,World Total,2736528,3049622,1625936,7412086,-,-
2001,Africa ,Africa Total,271,46515,18114,64900,-,-
2001,Africa ,Egypt ,53,1018,1400,2471,-,-
2001,Africa ,Libya ,75,4350,485,4910,-,-
2001,Africa ,Nigeria ,18,10500,1500,12018,-,-
2001,Africa ,Others or Unspecified ,125,30647,14729,45501,-,-
2001,East and South Asia,East and South Asia Total,70349,817144,511363,1398856,-,-
2001,East and South Asia,Brunei ,26,20240,1500,21766,-,-
2001,East and South Asia,Hong Kong,404,171485,2000,173889,-,-
2001,East and South Asia,Japan ,65647,138522,36379,240548,-,-
2001,East and South Asia,South Korea,1510,13781,15235,30526,-,-
2001,East and South Asia,Malaysia ,310,58233,363000,421543,-,-
2001,East and South Asia,Singapore ,152,56377,71917,128446,-,-
2001,East and South Asia,Taiwan ,1901,116480,4300,122681,-,-
2001,East and South Asia,Others or Unspecified ,399,242026,17032,259457,-,-
2001,West Asia,West Asia Total,1546,1232962,118287,1352795,-,-
2001,West Asia,Bahrain ,61,26356,5000,31417,-,-
2001,West Asia,Israel ,41,9058,21136,30235,-,-
2001,West Asia,Kuwait ,92,53067,10000,63159,-,-
2001,West Asia,Lebanon ,19,19825,5500,25344,-,-
2001,West Asia,Oman ,18,18551,1500,20069,-,-
2001,West Asia,Qatar ,13,37626,1000,38639,-,-
2001,West Asia,Saudi Arabia ,239,897000,18000,915239,-,-
2001,West Asia,United Arab Emirates ,373,128604,38000,166977,-,-
2001,West Asia,Others or Unspecified ,690,42875,18151,61716,-,-
2001,Europe ,Europe Total,152851,411248,174936,739035,-,-
2001,Europe ,Austria ,3205,1191,2000,6396,-,-
2001,Europe ,France ,925,4804,26121,31850,-,-
2001,Europe ,Germany ,41321,7005,4392,52718,-,-
2001,Europe ,Greece ,84,7514,17500,25098,-,-
2001,Europe ,Italy ,2431,69998,78000,150429,-,-
2001,Europe ,Netherlands,7632,2351,700,10683,-,-
2001,Europe ,Spain ,33643,5687,4000,43330,-,-
2001,Europe ,Switzerland ,605,5953,9300,15858,-,-
2001,Europe ,United Kingdom ,45889,15767,8344,70000,-,-
2001,Europe ,Others or Unspecified ,17116,290978,24579,332673,-,-
2001,Americas or Trust Territories ,Americas or Trust Territories Total,2291311,236475,773537,3301323,-,-
2001,Americas or Trust Territories ,Canada ,338561,21146,4000,363707,-,-
2001,Americas or Trust Territories ,United States ,1910844,60373,532200,2503417,-,-
2001,Americas or Trust Territories ,Commonwealth of the Northern Mariana Islands,80,16205,3705,19990,-,-
2001,Americas or Trust Territories ,Guam ,41541,434,2025,44000,-,-
2001,Americas or Trust Territories ,Others or Unspecified ,285,138317,231607,370209,-,-
2001,Oceania ,Oceania Total,220200,50009,29699,299908,-,-
2001,Oceania ,Australia ,204075,687,2041,206803,-,-
2001,Oceania ,New Zealand ,16045,236,100,16381,-,-
2001,Oceania ,Papua New Guinea ,63,1661,7339,9063,-,-
2001,Oceania ,Others or Unspecified ,17,47425,20219,67661,-,-
2001,Oceania ,Seabased Workers ,-,255269,-,255269,-,-
2002,World,World Total,2807356,3167978,1607170,7582504,-,-
2002,Africa ,Africa Total,317,49027,16899,66243,-,-
2002,Africa ,Egypt ,54,2337,110,2501,-,-
2002,Africa ,Equatorial Guinea ,-,1193,150,1343,-,-
2002,Africa ,Libya ,75,4350,485,4910,-,-
2002,Africa ,Nigeria ,18,10500,1700,12218,-,-
2002,Africa ,Others or Unspecified ,170,30647,14454,45271,-,-
2002,East and South Asia,East and South Asia Total,76445,818146,558705,1453296,-,-
2002,East and South Asia,Brunei ,26,18200,1500,19726,-,-
2002,East and South Asia,Hong Kong,404,171485,2000,173889,-,-
2002,East and South Asia,Japan ,71381,138522,76573,286476,-,-
2002,East and South Asia,South Korea,1565,13781,15235,30581,-,-
2002,East and South Asia,Macau ,56,16000,1000,17056,-,-
2002,East and South Asia,Malaysia ,311,58233,363000,421544,-,-
2002,East and South Asia,Papua New Guinea ,64,3661,7339,11064,-,-
2002,East and South Asia,Singapore ,152,56377,71917,128446,-,-
2002,East and South Asia,Taiwan ,1953,116480,4300,122733,-,-
2002,East and South Asia,Others or Unspecified ,533,225407,15841,241781,-,-
2002,West Asia,West Asia Total,2271,1257700,111650,1371621,-,-
2002,West Asia,Bahrain ,61,26356,5000,31417,-,-
2002,West Asia,Israel ,100,7400,22500,30000,-,-
2002,West Asia,Jordan ,108,5000,7000,12108,-,-
2002,West Asia,Kuwait ,92,53067,10000,63159,-,-
2002,West Asia,Lebanon ,19,19825,5500,25344,-,-
2002,West Asia,Oman ,18,18551,1500,20069,-,-
2002,West Asia,Qatar ,13,37626,1000,38639,-,-
2002,West Asia,Saudi Arabia ,242,897000,18000,915242,-,-
2002,West Asia,United Arab Emirates ,379,155000,20000,175379,-,-
2002,West Asia,Others or Unspecified ,1239,37875,21150,60264,-,-
2002,Europe ,Europe Total,162227,455112,185830,803169,-,-
2002,Europe ,Austria ,21760,1191,2000,24951,-,-
2002,Europe ,Belgium ,3348,2500,4933,10781,-,-
2002,Europe ,France ,1013,4804,26121,31938,-,-
2002,Europe ,Germany ,42044,7005,4392,53441,-,-
2002,Europe ,Greece ,86,15514,17500,33100,-,-
2002,Europe ,Italy ,3413,69998,78000,151411,-,-
2002,Europe ,Netherlands,10041,2351,700,13092,-,-
2002,Europe ,Spain ,15167,5687,4000,24854,-,-
2002,Europe ,Switzerland ,791,5953,9300,16044,-,-
2002,Europe ,United Kingdom ,46234,35767,8344,90345,-,-
2002,Europe ,Others or Unspecified ,18330,304342,30540,353212,-,-
2002,Americas or Trust Territories ,Americas or Trust Territories Total,2342597,281276,710424,3334297,-,-
2002,Americas or Trust Territories ,Canada ,349597,28130,4200,381927,-,-
2002,Americas or Trust Territories ,United States ,1946448,98572,510000,2555020,-,-
2002,Americas or Trust Territories ,Commonwealth of the Northern Mariana Islands,1284,14854,224,16362,-,-
2002,Americas or Trust Territories ,Guam ,43968,1450,1000,46418,-,-
2002,Americas or Trust Territories ,Others or Unspecified ,1300,138270,195000,334570,-,-
2002,Oceania ,Oceania Total,223499,51448,23662,298609,-,-
2002,Oceania ,Australia ,206794,687,2923,210404,-,-
2002,Oceania ,New Zealand ,16669,236,120,17025,-,-
2002,Oceania ,Palau ,5,3100,400,3505,-,-
2002,Oceania ,Others or Unspecified ,31,47425,20219,67675,-,-
2002,Seabased Workers ,Seabased Workers ,-,255269,-,255269,-,-
2003,World,World Total,2865412,3385001,1512765,7763178,-,-
2003,Africa ,Africa Total,318,53706,16955,70979,-,-
2003,Africa ,Egypt ,54,2383,1280,3717,-,-
2003,Africa ,Equatorial Guinea ,0,1471,150,1621,-,-
2003,Africa ,Libya ,75,5982,485,6542,-,-
2003,Africa ,Nigeria ,18,10939,586,11543,-,-
2003,Africa ,Others or Unspecified ,171,32931,14454,47556,-,-
2003,East and South Asia,East and South Asia Total,85570,944129,503173,1532872,-,-
2003,East and South Asia,Brunei ,26,21043,1500,22569,-,-
2003,East and South Asia,Hong Kong,404,185500,2500,188404,-,-
2003,East and South Asia,Japan ,77310,197268,30100,304678,-,-
2003,East and South Asia,South Korea,4561,28540,9015,42116,-,-
2003,East and South Asia,Macau ,56,16000,1000,17056,-,-
2003,East and South Asia,Malaysia ,311,59599,363000,422910,-,-
2003,East and South Asia,Singapore ,152,58194,71917,130263,-,-
2003,East and South Asia,Taiwan ,1992,151824,4300,158116,-,-
2003,East and South Asia,Others or Unspecified ,758,226161,19841,246760,-,-
2003,West Asia,West Asia Total,2290,1361409,108150,1471849,-,-
2003,West Asia,Bahrain ,63,28238,5000,33301,-,-
2003,West Asia,Israel ,104,9186,23000,32290,-,-
2003,West Asia,Jordan ,108,5235,7000,12343,-,-
2003,West Asia,Kuwait ,93,69217,10000,79310,-,-
2003,West Asia,Lebanon ,19,21521,5500,27040,-,-
2003,West Asia,Oman ,18,18632,1500,20150,-,-
2003,West Asia,Qatar ,13,44279,1000,45292,-,-
2003,West Asia,Saudi Arabia ,243,948329,18000,966572,-,-
2003,West Asia,United Arab Emirates ,389,172755,20000,193144,-,-
2003,West Asia,Others or Unspecified ,1240,44017,17150,62407,-,-
2003,Europe ,Europe Total,165030,459042,143810,767882,-,-
2003,Europe ,Austria ,21854,1203,2000,25057,-,-
2003,Europe ,Belgium ,3473,2524,4933,10930,-,-
2003,Europe ,France ,1082,4808,26121,32011,-,-
2003,Europe ,Germany ,42489,7015,4392,53896,-,-
2003,Europe ,Greece ,88,15527,7500,23115,-,-
2003,Europe ,Italy ,4075,70113,50000,124188,-,-
2003,Europe ,Netherlands,10250,2368,1000,13618,-,-
2003,Europe ,Spain ,15753,6071,4000,25824,-,-
2003,Europe ,Switzerland ,842,5971,6199,13012,-,-
2003,Europe ,United Kingdom ,46234,38256,7125,91615,-,-
2003,Europe ,Others or Unspecified ,18890,305186,30540,354616,-,-
2003,Americas or Trust Territories ,Americas or Trust Territories Total,2386036,286103,709676,3381815,-,-
2003,Americas or Trust Territories ,Canada ,359118,30027,2975,392120,-,-
2003,Americas or Trust Territories ,United States ,1979408,99815,510000,2589223,-,-
2003,Americas or Trust Territories ,Commonwealth of the Northern Mariana Islands,1288,15399,1201,17888,-,-
2003,Americas or Trust Territories ,Guam ,44917,1628,500,47045,-,-
2003,Americas or Trust Territories ,Others or Unspecified ,1305,139234,195000,335539,-,-
2003,Oceania ,Oceania Total,226168,55814,31001,312983,-,-
2003,Oceania ,Australia ,209017,716,2923,212656,-,-
2003,Oceania ,New Zealand ,17051,260,120,17431,-,-
2003,Oceania ,Palau ,5,3266,400,3671,-,-
2003,Oceania ,Papua New Guinea ,64,4140,7339,11543,-,-
2003,Oceania ,Others or Unspecified ,31,47432,20219,67682,-,-
2003,Region Unspecified ,Region Unspecified ,-,8767,-,8767,-,-
2003,Seabased Workers ,Seabased Workers ,-,216031,-,216031,-,-
2004,World,World Total,3204326,2899620,1039191,7143137,-,-
2004,Africa,Africa Total,764,31386,6570,38720,-,-
2004,Africa,Afars and Issas,0,9,5,14,-,-
2004,Africa,Algeria,0,1587,500,2087,-,-
2004,Africa,Angola,55,1000,500,1555,-,-
2004,Africa,Benin,0,42,20,62,-,-
2004,Africa,Botswana,15,274,100,389,-,-
2004,Africa,Burkina Faso,0,10,20,30,-,-
2004,Africa,Burundi,0,7,15,22,-,-
2004,Africa,Cameroon,0,50,30,80,-,-
2004,Africa,Cape Verde,0,19,10,29,-,-
2004,Africa,Central African Republic,0,46,15,61,-,-
2004,Africa,Chad,0,200,300,500,-,-
2004,Africa,Congo  ,0,260,100,360,-,-
2004,Africa,Congo Democratic Republic,0,5,0,5,-,-
2004,Africa,Cote D'Ivoire (Ivory Coast) ,5,32,60,97,-,-
2004,Africa,Djibouti,0,87,0,87,-,-
2004,Africa,Egypt,54,2620,1420,4094,-,-
2004,Africa,Equatorial Guinea,0,2569,150,2719,-,-
2004,Africa,Eritrea,0,85,5,90,-,-
2004,Africa,Ethiopia,0,56,20,76,-,-
2004,Africa,Gabon,0,150,50,200,-,-
2004,Africa,Gambia,0,50,10,60,-,-
2004,Africa,Ghana,25,128,100,253,-,-
2004,Africa,Guinea,2,161,20,183,-,-
2004,Africa,Guinea Bissau,0,8,3,11,-,-
2004,Africa,Kenya,0,214,50,264,-,-
2004,Africa,Lesotho,30,155,30,215,-,-
2004,Africa,Liberia,20,94,30,144,-,-
2004,Africa,Libya,75,5440,490,6005,-,-
2004,Africa,Madagascar,0,77,0,77,-,-
2004,Africa,Malawi,0,70,10,80,-,-
2004,Africa,Mali,0,66,20,86,-,-
2004,Africa,Mauritania,0,12,0,12,-,-
2004,Africa,Mauritius,0,14,10,24,-,-
2004,Africa,Morocco,0,188,100,288,-,-
2004,Africa,Mozambique,35,82,50,167,-,-
2004,Africa,Namibia,45,653,200,898,-,-
2004,Africa,Nigeria ,18,11750,600,12368,-,-
2004,Africa,Rwanda,0,5,5,10,-,-
2004,Africa,Sao Tome and Principe,0,51,10,61,-,-
2004,Africa,Senegal,5,26,10,41,-,-
2004,Africa,Seychelles,0,364,100,464,-,-
2004,Africa,Sierra Leone,6,45,2,53,-,-
2004,Africa,Somalia,0,5,0,5,-,-
2004,Africa,South Africa,146,1431,500,2077,-,-
2004,Africa,Sudan,200,638,500,1338,-,-
2004,Africa,Swaziland,12,156,100,268,-,-
2004,Africa,Tanzania,0,40,50,90,-,-
2004,Africa,Togo,5,50,10,65,-,-
2004,Africa,Tunisia,0,35,20,55,-,-
2004,Africa,Uganda,0,77,20,97,-,-
2004,Africa,Zambia,5,98,150,253,-,-
2004,Africa,Zimbabwe,6,95,50,151,-,-
2004,East and South Asia,East and South Asia Total,95310,801521,434312,1331143,-,-
2004,East and South Asia,Afghanistan,0,500,300,800,-,-
2004,East and South Asia,Bangladesh,28,429,70,527,-,-
2004,East and South Asia,Bhutan,0,4,2,6,-,-
2004,East and South Asia,Brunei,26,21762,1700,23488,-,-
2004,East and South Asia,Cambodia,6,719,600,1325,-,-
2004,East and South Asia,China,360,7991,4000,12351,-,-
2004,East and South Asia,Hong Kong,404,194241,2700,197345,-,-
2004,East and South Asia,India,176,300,300,776,-,-
2004,East and South Asia,Indonesia,317,8426,500,9243,-,-
2004,East and South Asia,Japan,83303,238522,31430,353255,-,-
2004,East and South Asia,Kazakhstan,0,450,100,550,-,-
2004,East and South Asia,North Korea,0,5,10,15,-,-
2004,East and South Asia,South Korea,4850,33285,9015,47150,-,-
2004,East and South Asia,Kyrgyzstan,0,7,5,12,-,-
2004,East and South Asia,Laos,2,150,30,182,-,-
2004,East and South Asia,Macau,56,17391,1000,18447,-,-
2004,East and South Asia,Malaysia,313,52337,300000,352650,-,-
2004,East and South Asia,Maldives,18,346,500,864,-,-
2004,East and South Asia,Mongolia,0,44,20,64,-,-
2004,East and South Asia,Myanmar,57,278,150,485,-,-
2004,East and South Asia,Nepal,55,69,10,134,-,-
2004,East and South Asia,Pakistan,150,374,800,1324,-,-
2004,East and South Asia,Singapore,152,64337,72000,136489,-,-
2004,East and South Asia,Sri Lanka,0,605,200,805,-,-
2004,East and South Asia,Taiwan,2037,154135,4500,160672,-,-
2004,East and South Asia,Tajikistan,0,10,10,20,-,-
2004,East and South Asia,Thailand,3000,3627,3000,9627,-,-
2004,East and South Asia,Timor-Leste,0,146,300,446,-,-
2004,East and South Asia,Turkmenistan,0,185,50,235,-,-
2004,East and South Asia,Uzbekistan,0,49,10,59,-,-
2004,East and South Asia,Vietnam,0,797,1000,1797,-,-
2004,West Asia,West Asia Total,2078,1417422,102700,1522200,-,-
2004,West Asia,Bahrain,64,33154,3500,36718,-,-
2004,West Asia,Iran,800,350,2000,3150,-,-
2004,West Asia,Iraq,45,3373,2800,6218,-,-
2004,West Asia,Israel,104,14051,23000,37155,-,-
2004,West Asia,Jordan,108,5885,7000,12993,-,-
2004,West Asia,Kuwait,93,80196,11500,91789,-,-
2004,West Asia,Lebanon,19,28318,6100,34437,-,-
2004,West Asia,Oman,20,18941,1500,20461,-,-
2004,West Asia,Qatar,13,57345,1000,58358,-,-
2004,West Asia,Saudi Arabia,243,976134,18000,994377,-,-
2004,West Asia,Syria,134,13468,6000,19602,-,-
2004,West Asia,United Arab Emirates,405,185562,20000,205967,-,-
2004,West Asia,Yemen,30,665,300,995,-,-
2004,Europe,Europe Total,186966,234957,126149,548072,-,-
2004,Europe,Albania,0,4,2,6,-,-
2004,Europe,Andorra,0,636,50,686,-,-
2004,Europe,Armenia,0,12,0,12,-,-
2004,Europe,Austria,22017,1956,2000,25973,-,-
2004,Europe,Azerbaijan,300,350,400,1050,-,-
2004,Europe,"Baltic States (Estonia, Latvia, Lithuania)",0,20,2,22,-,-
2004,Europe,Belorussia (Belarus),0,14,3,17,-,-
2004,Europe,Belgium,3583,3484,5535,12602,-,-
2004,Europe,Bosnia and Herzegovina,2,16,2,20,-,-
2004,Europe,Bulgaria,14,10,20,44,-,-
2004,Europe,Channel Island,0,1,0,1,-,-
2004,Europe,Croatia,7,43,3,53,-,-
2004,Europe,Cyprus,19,10039,3750,13808,-,-
2004,Europe,Czech Republic,33,96,20,149,-,-
2004,Europe,Denmark,4996,2680,-,7676,-,-
2004,Europe,Finland,1431,162,10,1603,-,-
2004,Europe,France,1098,4866,26120,32084,-,-
2004,Europe,Georgia,5,44,20,69,-,-
2004,Europe,Germany,42882,8346,4400,55628,-,-
2004,Europe,Gibraltar,0,6,5,11,-,-
2004,Europe,Greece,88,17058,8000,25146,-,-
2004,Europe,Greenland,0,2,0,2,-,-
2004,Europe,Hungary,24,80,10,114,-,-
2004,Europe,Iceland,802,573,10,1385,-,-
2004,Europe,Ireland,90,9500,600,10190,-,-
2004,Europe,Isle of Man,0,34,0,34,-,-
2004,Europe,Italy,4934,85527,48000,138461,-,-
2004,Europe,Liechtenstein,9,30,20,59,-,-
2004,Europe,Luxembourg,353,75,240,668,-,-
2004,Europe,Macedonia,0,50,5,55,-,-
2004,Europe,Malta,0,82,20,102,-,-
2004,Europe,Moldova,0,2,2,4,-,-
2004,Europe,Monaco,200,95,2700,2995,-,-
2004,Europe,Netherlands,10421,2920,2000,15341,-,-
2004,Europe,Norway,15797,2811,0,18608,-,-
2004,Europe,Poland,47,69,40,156,-,-
2004,Europe,Portugal,384,241,3300,3925,-,-
2004,Europe,Romania,2,118,40,160,-,-
2004,Europe,Russian Federation,10,1500,500,2010,-,-
2004,Europe,San Marino,0,20,5,25,-,-
2004,Europe,Serbia and Montenegro,6,25,5,36,-,-
2004,Europe,Slovak Republic,7,25,5,37,-,-
2004,Europe,Slovenia,18,4,5,27,-,-
2004,Europe,Spain,16332,6960,2000,25292,-,-
2004,Europe,Sweden,6962,10191,10,17163,-,-
2004,Europe,Switzerland,922,7025,6700,14647,-,-
2004,Europe,Turkey,666,680,2000,3346,-,-
2004,Europe,Ukraine,0,15,5,20,-,-
2004,Europe,United Kingdom,52500,56341,7480,116321,-,-
2004,Europe,Vatican,5,100,100,205,-,-
2004,Europe,Yugoslavia,0,19,5,24,-,-
2004,Americas or Trust Territories,Americas or Trust Territories Total,2690224,172709,358610,3221543,-,-
2004,Americas or Trust Territories,American Samoa,50,1450,500,2000,-,-
2004,Americas or Trust Territories,Anguilla,0,22,5,27,-,-
2004,Americas or Trust Territories,Antigua and Barbuda,0,27,5,32,-,-
2004,Americas or Trust Territories,Argentina,49,199,20,268,-,-
2004,Americas or Trust Territories,Aruba,349,2138,500,2987,-,-
2004,Americas or Trust Territories,Bahamas,0,190,100,290,-,-
2004,Americas or Trust Territories,Barbados,4,80,20,104,-,-
2004,Americas or Trust Territories,Belize,17,80,5,102,-,-
2004,Americas or Trust Territories,Bermuda,0,200,100,300,-,-
2004,Americas or Trust Territories,Bolivia,5,15,0,20,-,-
2004,Americas or Trust Territories,Bonaire,0,5,0,5,-,-
2004,Americas or Trust Territories,Brazil,205,147,40,392,-,-
2004,Americas or Trust Territories,British Virgin Islands,0,20,5,25,-,-
2004,Americas or Trust Territories,Canada,369225,32766,2975,404966,-,-
2004,Americas or Trust Territories,Cayman Islands,0,500,100,600,-,-
2004,Americas or Trust Territories,Chile,0,131,20,151,-,-
2004,Americas or Trust Territories,Commonwealth of the Northern Mariana Islands,1288,16753,1250,19291,-,-
2004,Americas or Trust Territories,Colombia,19,10,10,39,-,-
2004,Americas or Trust Territories,Cook Islands,80,31,0,111,-,-
2004,Americas or Trust Territories,Costa Rica,31,154,10,195,-,-
2004,Americas or Trust Territories,Cuba,200,260,100,560,-,-
2004,Americas or Trust Territories,Curacao,0,25,0,25,-,-
2004,Americas or Trust Territories,Diego Garcia,0,3607,300,3907,-,-
2004,Americas or Trust Territories,Dominica,0,6,0,6,-,-
2004,Americas or Trust Territories,Dominican Republic,0,93,5,98,-,-
2004,Americas or Trust Territories,Ecuador,20,55,25,100,-,-
2004,Americas or Trust Territories,El Salvador,10,25,5,40,-,-
2004,Americas or Trust Territories,Fiji,0,125,0,125,-,-
2004,Americas or Trust Territories,French Polynesia,0,1000,0,1000,-,-
2004,Americas or Trust Territories,Grenada,0,13,0,13,-,-
2004,Americas or Trust Territories,Guam,45968,1800,500,48268,-,-
2004,Americas or Trust Territories,Guatemala,74,143,20,237,-,-
2004,Americas or Trust Territories,Guyana,5,62,5,72,-,-
2004,Americas or Trust Territories,Haiti,251,8,50,309,-,-
2004,Americas or Trust Territories,Honduras,57,213,20,290,-,-
2004,Americas or Trust Territories,Jamaica,26,195,40,261,-,-
2004,Americas or Trust Territories,Marshall Islands (Majuro),0,600,50,650,-,-
2004,Americas or Trust Territories,Mexico,21,196,100,317,-,-
2004,Americas or Trust Territories,Federated States of Micronesia,0,1426,200,1626,-,-
2004,Americas or Trust Territories,Netherlands Antilles,0,25,5,30,-,-
2004,Americas or Trust Territories,Nicaragua,14,31,5,50,-,-
2004,Americas or Trust Territories,Palau,21,3000,1000,4021,-,-
2004,Americas or Trust Territories,Panama,19,76,10,105,-,-
2004,Americas or Trust Territories,Paraguay,15,50,5,70,-,-
2004,Americas or Trust Territories,Peru,46,94,10,150,-,-
2004,Americas or Trust Territories,Puerto Rico,10,300,20,330,-,-
2004,Americas or Trust Territories,Solomon,33,400,130,563,-,-
2004,Americas or Trust Territories,Saint Kitts and Nevis,0,3,0,3,-,-
2004,Americas or Trust Territories,Saint Lucia,0,0,0,0,-,-
2004,Americas or Trust Territories,Saint Vincent and The Grenadines,0,16,5,21,-,-
2004,Americas or Trust Territories,Suriname,63,196,50,309,-,-
2004,Americas or Trust Territories,Trinidad and Tobago,21,115,50,186,-,-
2004,Americas or Trust Territories,Turks and Caicos Island (West Indies),0,400,0,400,-,-
2004,Americas or Trust Territories,United States ,2271933,101249,350000,2723182,-,-
2004,Americas or Trust Territories,Uruguay,0,10,10,20,-,-
2004,Americas or Trust Territories,Vanuatu,0,120,0,120,-,-
2004,Americas or Trust Territories,Venezuela,95,116,20,231,-,-
2004,Americas or Trust Territories,US Virgin Islands,0,1486,200,1686,-,-
2004,Americas or Trust Territories,West Indies,0,252,5,257,-,-
2004,Oceania,Oceania Total,228984,12603,10850,252437,-,-
2004,Oceania,Australia,211664,930,2900,215494,-,-
2004,Oceania,Kiribati,19,200,70,289,-,-
2004,Oceania,Nauru,0,261,10,271,-,-
2004,Oceania,New Caledonia,50,2081,0,2131,-,-
2004,Oceania,New Zealand,17182,307,120,17609,-,-
2004,Oceania,Palau,5,3702,400,4107,-,-
2004,Oceania,Papua New Guinea,64,5030,7350,12444,-,-
2004,Oceania,Samoa,0,25,0,25,-,-
2004,Oceania,Tonga,0,60,0,60,-,-
2004,Oceania,Tuvalu,0,7,0,7,-,-
2004,Seabased Workers,Seabased Workers,-,229002,-,229002,-,-
2005,World,World Total,3407967,2943151,626389,6977507,-,-
2005,Africa,Africa Total,764,32403,6900,40067,-,-
2005,Africa,Afars and Issas,0,9,5,14,-,-
2005,Africa,Algeria,0,1832,500,2332,-,-
2005,Africa,Angola,55,1500,500,2055,-,-
2005,Africa,Benin,0,42,20,62,-,-
2005,Africa,Botswana,15,288,100,403,-,-
2005,Africa,Burkina Faso,0,10,20,30,-,-
2005,Africa,Burundi,0,8,15,23,-,-
2005,Africa,Cameroon,0,65,30,95,-,-
2005,Africa,Cape Verde,0,20,25,45,-,-
2005,Africa,Central African Republic,0,47,20,67,-,-
2005,Africa,Chad,0,238,300,538,-,-
2005,Africa,Congo  ,0,374,100,474,-,-
2005,Africa,Congo Democratic Republic,0,5,0,5,-,-
2005,Africa,Cote D'Ivoire (Ivory Coast) ,5,59,60,124,-,-
2005,Africa,Djibouti,0,90,0,90,-,-
2005,Africa,Egypt,54,2519,1420,3993,-,-
2005,Africa,Equatorial Guinea,0,3560,150,3710,-,-
2005,Africa,Eritrea,0,52,5,57,-,-
2005,Africa,Ethiopia,0,56,20,76,-,-
2005,Africa,Gabon,0,150,50,200,-,-
2005,Africa,Gambia,0,50,10,60,-,-
2005,Africa,Ghana,25,172,120,317,-,-
2005,Africa,Guinea,2,164,30,196,-,-
2005,Africa,Guinea Bissau,0,8,3,11,-,-
2005,Africa,Kenya,0,183,50,233,-,-
2005,Africa,Lesotho,30,176,30,236,-,-
2005,Africa,Liberia,20,100,10,130,-,-
2005,Africa,Libya,75,3682,490,4247,-,-
2005,Africa,Madagascar,0,117,0,117,-,-
2005,Africa,Malawi,0,77,10,87,-,-
2005,Africa,Mali,0,60,20,80,-,-
2005,Africa,Mauritania,0,12,0,12,-,-
2005,Africa,Mauritius,0,14,10,24,-,-
2005,Africa,Morocco,0,318,100,418,-,-
2005,Africa,Mozambique,35,124,50,209,-,-
2005,Africa,Namibia,45,661,100,806,-,-
2005,Africa,Nigeria ,18,12214,600,12832,-,-
2005,Africa,Rwanda,0,3,5,8,-,-
2005,Africa,Sao Tome and Principe,0,38,10,48,-,-
2005,Africa,Senegal,5,27,10,42,-,-
2005,Africa,Seychelles,0,552,100,652,-,-
2005,Africa,Sierra Leone,6,45,2,53,-,-
2005,Africa,Somalia,0,3,0,3,-,-
2005,Africa,South Africa,146,1416,650,2212,-,-
2005,Africa,Sudan,200,638,700,1538,-,-
2005,Africa,Swaziland,12,199,150,361,-,-
2005,Africa,Tanzania,0,40,50,90,-,-
2005,Africa,Togo,5,50,10,65,-,-
2005,Africa,Tunisia,0,68,20,88,-,-
2005,Africa,Uganda,0,71,20,91,-,-
2005,Africa,Zambia,5,100,150,255,-,-
2005,Africa,Zimbabwe,6,97,50,153,-,-
2005,East and South Asia,East and South Asia Total,190315,687002,230555,1107872,-,-
2005,East and South Asia,Afghanistan,0,500,370,870,-,-
2005,East and South Asia,Bangladesh,28,549,50,627,-,-
2005,East and South Asia,Bhutan,0,4,2,6,-,-
2005,East and South Asia,Brunei,27,18677,2000,20704,-,-
2005,East and South Asia,Cambodia,6,927,1000,1933,-,-
2005,East and South Asia,China,360,11754,4000,16114,-,-
2005,East and South Asia,Hong Kong,11644,166457,3000,181101,-,-
2005,East and South Asia,India,176,341,500,1017,-,-
2005,East and South Asia,Indonesia,317,9115,800,10232,-,-
2005,East and South Asia,Japan,114980,139791,30619,285390,-,-
2005,East and South Asia,Kazakhstan,0,450,100,550,-,-
2005,East and South Asia,North Korea,0,5,10,15,-,-
2005,East and South Asia,South Korea,5330,40918,13519,59767,-,-
2005,East and South Asia,Kyrgyzstan,0,7,5,12,-,-
2005,East and South Asia,Laos,2,177,30,209,-,-
2005,East and South Asia,Macau,56,17916,1000,18972,-,-
2005,East and South Asia,Malaysia,26000,88601,125000,239601,-,-
2005,East and South Asia,Maldives,18,415,600,1033,-,-
2005,East and South Asia,Mongolia,0,60,20,80,-,-
2005,East and South Asia,Myanmar,57,357,150,564,-,-
2005,East and South Asia,Nepal,55,75,10,140,-,-
2005,East and South Asia,Pakistan,151,299,1000,1450,-,-
2005,East and South Asia,Singapore,26000,68761,37600,132361,-,-
2005,East and South Asia,Sri Lanka,0,812,200,1012,-,-
2005,East and South Asia,Taiwan,2108,113489,4500,120097,-,-
2005,East and South Asia,Tajikistan,0,9,10,19,-,-
2005,East and South Asia,Thailand,3000,5112,3000,11112,-,-
2005,East and South Asia,Timor-Leste,0,146,400,546,-,-
2005,East and South Asia,Turkmenistan,0,128,50,178,-,-
2005,East and South Asia,Uzbekistan,0,50,10,60,-,-
2005,East and South Asia,Vietnam,0,1100,1000,2100,-,-
2005,West Asia,West Asia Total,2096,1532554,103700,1638350,-,-
2005,West Asia,Bahrain,64,37999,3500,41563,-,-
2005,West Asia,Iran,800,350,3000,4150,-,-
2005,West Asia,Iraq,45,3371,2800,6216,-,-
2005,West Asia,Israel,112,17143,23000,40255,-,-
2005,West Asia,Jordan,108,9166,7000,16274,-,-
2005,West Asia,Kuwait,93,103072,11500,114665,-,-
2005,West Asia,Lebanon,19,41912,6100,48031,-,-
2005,West Asia,Oman,21,19035,1500,20556,-,-
2005,West Asia,Qatar,13,78029,1000,79042,-,-
2005,West Asia,Saudi Arabia,244,976427,18000,994671,-,-
2005,West Asia,Syria,134,13374,6000,19508,-,-
2005,West Asia,United Arab Emirates,413,231784,20000,252197,-,-
2005,West Asia,Yemen,30,892,300,1222,-,-
2005,Europe,Europe Total,223819,245930,107256,577005,-,-
2005,Europe,Albania,0,4,2,6,-,-
2005,Europe,Andorra,0,687,50,737,-,-
2005,Europe,Armenia,0,16,0,16,-,-
2005,Europe,Austria,30000,4238,962,35200,-,-
2005,Europe,Azerbaijan,300,350,500,1150,-,-
2005,Europe,"Baltic States (Estonia, Latvia, Lithuania)",0,25,2,27,-,-
2005,Europe,Belorussia (Belarus),0,15,3,18,-,-
2005,Europe,Belgium,3724,3422,5535,12681,-,-
2005,Europe,Bosnia and Herzegovina,2,11,2,15,-,-
2005,Europe,Bulgaria,14,8,20,42,-,-
2005,Europe,Channel Island,0,1,0,1,-,-
2005,Europe,Croatia,8,25,3,36,-,-
2005,Europe,Cyprus,19,11251,3000,14270,-,-
2005,Europe,Czech Republic,33,100,20,153,-,-
2005,Europe,Denmark,5023,2701,-,7724,-,-
2005,Europe,Finland,1455,141,10,1606,-,-
2005,Europe,France,900,4320,40105,45325,-,-
2005,Europe,Georgia,5,44,20,69,-,-
2005,Europe,Germany,43249,8268,4400,55917,-,-
2005,Europe,Gibraltar,0,6,5,11,-,-
2005,Europe,Greece,89,18120,8000,26209,-,-
2005,Europe,Greenland,0,2,0,2,-,-
2005,Europe,Hungary,24,76,10,110,-,-
2005,Europe,Iceland,822,629,10,1461,-,-
2005,Europe,Ireland,90,10000,600,10690,-,-
2005,Europe,Isle of Man,0,38,0,38,-,-
2005,Europe,Italy,22154,81232,20000,123386,-,-
2005,Europe,Liechtenstein,9,30,30,69,-,-
2005,Europe,Luxembourg,359,72,240,671,-,-
2005,Europe,Macedonia,0,50,5,55,-,-
2005,Europe,Malta,1,93,20,114,-,-
2005,Europe,Moldova,0,2,2,4,-,-
2005,Europe,Monaco,200,97,2900,3197,-,-
2005,Europe,Netherlands,12897,2931,2000,17828,-,-
2005,Europe,Norway,15979,2887,0,18866,-,-
2005,Europe,Poland,47,80,40,167,-,-
2005,Europe,Portugal,386,303,3500,4189,-,-
2005,Europe,Romania,2,130,40,172,-,-
2005,Europe,Russian Federation,10,2000,500,2510,-,-
2005,Europe,San Marino,0,20,5,25,-,-
2005,Europe,Serbia and Montenegro,6,20,5,31,-,-
2005,Europe,Slovak Republic,7,25,5,37,-,-
2005,Europe,Slovenia,19,5,5,29,-,-
2005,Europe,Spain,17017,5927,2000,24944,-,-
2005,Europe,Sweden,7214,10140,10,17364,-,-
2005,Europe,Switzerland,8107,1896,2000,12003,-,-
2005,Europe,Turkey,666,719,3000,4385,-,-
2005,Europe,Ukraine,0,15,5,20,-,-
2005,Europe,United Kingdom,52977,72638,7480,133095,-,-
2005,Europe,Vatican,5,100,200,305,-,-
2005,Europe,Yugoslavia,0,20,5,25,-,-
2005,Americas or Trust Territories,Americas or Trust Territories Total,2758569,184560,167128,3110257,-,-
2005,Americas or Trust Territories,American Samoa,50,1450,500,2000,-,-
2005,Americas or Trust Territories,Anguilla,0,42,5,47,-,-
2005,Americas or Trust Territories,Antigua and Barbuda,0,30,5,35,-,-
2005,Americas or Trust Territories,Argentina,49,205,20,274,-,-
2005,Americas or Trust Territories,Aruba,350,2208,500,3058,-,-
2005,Americas or Trust Territories,Bahamas,0,190,100,290,-,-
2005,Americas or Trust Territories,Barbados,4,60,20,84,-,-
2005,Americas or Trust Territories,Belize,17,80,5,102,-,-
2005,Americas or Trust Territories,Bermuda,0,200,100,300,-,-
2005,Americas or Trust Territories,Bolivia,5,15,0,20,-,-
2005,Americas or Trust Territories,Bonaire,0,5,0,5,-,-
2005,Americas or Trust Territories,Brazil,207,191,40,438,-,-
2005,Americas or Trust Territories,British Virgin Islands,0,20,5,25,-,-
2005,Americas or Trust Territories,Canada,382824,34438,2975,420237,-,-
2005,Americas or Trust Territories,Cayman Islands,0,800,100,900,-,-
2005,Americas or Trust Territories,Chile,0,136,20,156,-,-
2005,Americas or Trust Territories,Commonwealth of the Northern Mariana Islands,1288,16392,1250,18930,-,-
2005,Americas or Trust Territories,Colombia,19,10,10,39,-,-
2005,Americas or Trust Territories,Cook Islands,80,31,0,111,-,-
2005,Americas or Trust Territories,Costa Rica,31,160,10,201,-,-
2005,Americas or Trust Territories,Cuba,200,400,200,800,-,-
2005,Americas or Trust Territories,Curacao,0,25,0,25,-,-
2005,Americas or Trust Territories,Diego Garcia,0,2547,300,2847,-,-
2005,Americas or Trust Territories,Dominica,0,5,0,5,-,-
2005,Americas or Trust Territories,Dominican Republic,0,86,5,91,-,-
2005,Americas or Trust Territories,Ecuador,20,55,35,110,-,-
2005,Americas or Trust Territories,El Salvador,10,31,5,46,-,-
2005,Americas or Trust Territories,Fiji,0,125,0,125,-,-
2005,Americas or Trust Territories,French Polynesia,1,1000,0,1001,-,-
2005,Americas or Trust Territories,Grenada,0,13,0,13,-,-
2005,Americas or Trust Territories,Guam,45968,1339,700,48007,-,-
2005,Americas or Trust Territories,Guatemala,74,144,20,238,-,-
2005,Americas or Trust Territories,Guyana,5,35,10,50,-,-
2005,Americas or Trust Territories,Haiti,251,8,100,359,-,-
2005,Americas or Trust Territories,Honduras,57,206,25,288,-,-
2005,Americas or Trust Territories,Jamaica,26,191,40,257,-,-
2005,Americas or Trust Territories,Marshall Islands (Majuro),0,904,50,954,-,-
2005,Americas or Trust Territories,Mexico,21,300,100,421,-,-
2005,Americas or Trust Territories,Federated States of Micronesia,0,1523,300,1823,-,-
2005,Americas or Trust Territories,Netherlands Antilles,0,31,5,36,-,-
2005,Americas or Trust Territories,Nicaragua,14,35,5,54,-,-
2005,Americas or Trust Territories,Palau,21,3000,1000,4021,-,-
2005,Americas or Trust Territories,Panama,19,101,10,130,-,-
2005,Americas or Trust Territories,Paraguay,15,50,5,70,-,-
2005,Americas or Trust Territories,Peru,46,94,10,150,-,-
2005,Americas or Trust Territories,Puerto Rico,10,300,20,330,-,-
2005,Americas or Trust Territories,Solomon,33,599,130,762,-,-
2005,Americas or Trust Territories,Saint Kitts and Nevis,0,3,0,3,-,-
2005,Americas or Trust Territories,Saint Lucia,0,0,0,0,-,-
2005,Americas or Trust Territories,Saint Vincent and The Grenadines,0,20,5,25,-,-
2005,Americas or Trust Territories,Suriname,63,200,50,313,-,-
2005,Americas or Trust Territories,Trinidad and Tobago,21,295,100,416,-,-
2005,Americas or Trust Territories,Turks and Caicos Island (West Indies),0,400,0,400,-,-
2005,Americas or Trust Territories,United States ,2326675,111835,157998,2596508,-,-
2005,Americas or Trust Territories,Uruguay,0,7,10,17,-,-
2005,Americas or Trust Territories,Vanuatu,0,120,0,120,-,-
2005,Americas or Trust Territories,Venezuela,95,120,20,235,-,-
2005,Americas or Trust Territories,US Virgin Islands,0,1500,200,1700,-,-
2005,Americas or Trust Territories,West Indies,0,250,5,255,-,-
2005,Oceania,Oceania Total,232404,12995,10850,256249,-,-
2005,Oceania,Australia,214690,1332,2900,218922,-,-
2005,Oceania,Kiribati,19,250,70,339,-,-
2005,Oceania,Nauru,0,240,10,250,-,-
2005,Oceania,New Caledonia,50,2080,0,2130,-,-
2005,Oceania,New Zealand,17576,424,120,18120,-,-
2005,Oceania,Palau,5,3702,400,4107,-,-
2005,Oceania,Papua New Guinea,64,4875,7350,12289,-,-
2005,Oceania,Samoa,0,25,0,25,-,-
2005,Oceania,Tonga,0,60,0,60,-,-
2005,Oceania,Tuvalu,0,7,0,7,-,-
2005,Seabased Workers,Seabased Workers,-,247707,-,247707,-,-
2006,World,World Total,3568388,3093921,621713,7284022,-,-
2006,Africa,Africa Total,999,41880,7482,50361,-,-
2006,Africa,Afars and Issas ,0,8,5,13,-,-
2006,Africa,Algeria ,0,1800,500,2300,-,-
2006,Africa,Angola ,55,2000,500,2555,-,-
2006,Africa,Benin ,0,48,20,68,-,-
2006,Africa,Botswana ,15,288,100,403,-,-
2006,Africa,Burkina Faso ,0,10,20,30,-,-
2006,Africa,Burundi ,0,8,15,23,-,-
2006,Africa,Cameroon ,0,150,30,180,-,-
2006,Africa,Cape Verde ,0,20,25,45,-,-
2006,Africa,Central African Republic,0,48,20,68,-,-
2006,Africa,Chad ,0,338,300,638,-,-
2006,Africa,Congo ,0,500,100,600,-,-
2006,Africa,Congo Democratic Republic,0,5,0,5,-,-
2006,Africa,Cote D'Ivoire (Ivory Coast) ,5,63,60,128,-,-
2006,Africa,Djibouti ,0,102,0,102,-,-
2006,Africa,Egypt ,246,2190,1200,3636,-,-
2006,Africa,Equatorial Guinea ,40,4072,662,4774,-,-
2006,Africa,Eritrea ,0,62,5,67,-,-
2006,Africa,Ethiopia ,0,52,20,72,-,-
2006,Africa,Gabon ,0,200,50,250,-,-
2006,Africa,Gambia ,0,50,10,60,-,-
2006,Africa,Ghana ,25,223,120,368,-,-
2006,Africa,Guinea ,2,189,30,221,-,-
2006,Africa,Guinea Bissau ,0,8,3,11,-,-
2006,Africa,Kenya ,0,185,50,235,-,-
2006,Africa,Lesotho ,30,201,30,261,-,-
2006,Africa,Liberia ,20,110,10,140,-,-
2006,Africa,Libya ,75,9475,680,10230,-,-
2006,Africa,Madagascar ,0,140,0,140,-,-
2006,Africa,Malawi ,0,88,10,98,-,-
2006,Africa,Mali ,0,60,20,80,-,-
2006,Africa,Mauritania ,0,14,0,14,-,-
2006,Africa,Mauritius ,0,14,10,24,-,-
2006,Africa,Morocco ,0,399,100,499,-,-
2006,Africa,Mozambique ,35,136,50,221,-,-
2006,Africa,Namibia ,45,792,100,937,-,-
2006,Africa,Nigeria ,18,13428,700,14146,-,-
2006,Africa,Rwanda ,0,2,5,7,-,-
2006,Africa,Sao Tome and Principe ,0,22,10,32,-,-
2006,Africa,Senegal ,5,40,10,55,-,-
2006,Africa,Seychelles ,0,727,100,827,-,-
2006,Africa,Sierra Leone ,6,45,2,53,-,-
2006,Africa,Somalia ,0,3,0,3,-,-
2006,Africa,South Africa ,149,1344,650,2143,-,-
2006,Africa,Sudan ,200,1489,700,2389,-,-
2006,Africa,Swaziland ,12,230,150,392,-,-
2006,Africa,Tanzania ,0,45,50,95,-,-
2006,Africa,Togo ,5,50,10,65,-,-
2006,Africa,Tunisia ,0,63,20,83,-,-
2006,Africa,Uganda ,0,85,20,105,-,-
2006,Africa,Zambia ,5,162,150,317,-,-
2006,Africa,Zimbabwe ,6,97,50,153,-,-
2006,East and South Asia,East and South Asia Total,200436,583454,232542,1016432,-,-
2006,East and South Asia,Afghanistan ,0,703,395,1098,-,-
2006,East and South Asia,Bangladesh ,28,505,50,583,-,-
2006,East and South Asia,Bhutan ,0,5,2,7,-,-
2006,East and South Asia,Brunei ,50,16726,400,17176,-,-
2006,East and South Asia,Cambodia ,6,1205,1500,2711,-,-
2006,East and South Asia,China ,360,16379,4500,21239,-,-
2006,East and South Asia,Hong Kong,11471,121644,3000,136115,-,-
2006,East and South Asia,India ,177,500,500,1177,-,-
2006,East and South Asia,Indonesia ,317,9186,800,10303,-,-
2006,East and South Asia,Japan ,124722,103555,30700,258977,-,-
2006,East and South Asia,Kazakhstan,0,500,100,600,-,-
2006,East and South Asia,North Korea,0,5,10,15,-,-
2006,East and South Asia,South Korea,5611,50600,14000,70211,-,-
2006,East and South Asia,Kyrgyzstan ,0,5,5,10,-,-
2006,East and South Asia,Laos ,2,228,30,260,-,-
2006,East and South Asia,Macau ,56,18735,1000,19791,-,-
2006,East and South Asia,Malaysia ,26001,88372,125000,239373,-,-
2006,East and South Asia,Maldives ,18,672,800,1490,-,-
2006,East and South Asia,Mongolia ,0,59,20,79,-,-
2006,East and South Asia,Myanmar ,57,357,150,564,-,-
2006,East and South Asia,Nepal ,55,70,10,135,-,-
2006,East and South Asia,Pakistan ,151,255,1500,1906,-,-
2006,East and South Asia,Singapore ,26000,75318,38000,139318,-,-
2006,East and South Asia,Sri Lanka ,0,845,200,1045,-,-
2006,East and South Asia,Taiwan ,2295,68328,4500,75123,-,-
2006,East and South Asia,Tajikistan ,0,8,10,18,-,-
2006,East and South Asia,Thailand ,3059,6340,3600,12999,-,-
2006,East and South Asia,Timor-Leste ,0,429,400,829,-,-
2006,East and South Asia,Turkmenistan ,0,141,50,191,-,-
2006,East and South Asia,Uzbekistan ,0,49,10,59,-,-
2006,East and South Asia,Vietnam ,0,1730,1300,3030,-,-
2006,West Asia,West Asia Total,3287,1689338,103200,1795825,-,-
2006,West Asia,Bahrain ,65,44143,3500,47708,-,-
2006,West Asia,Iran ,800,367,3000,4167,-,-
2006,West Asia,Iraq ,45,3369,2800,6214,-,-
2006,West Asia,Israel ,1000,26565,22500,50065,-,-
2006,West Asia,Jordan ,108,14430,7000,21538,-,-
2006,West Asia,Kuwait ,94,133361,11500,144955,-,-
2006,West Asia,Lebanon ,300,23012,6100,29412,-,-
2006,West Asia,Oman ,21,21017,1500,22538,-,-
2006,West Asia,Qatar ,13,115874,1000,116887,-,-
2006,West Asia,Saudi Arabia ,247,1001330,18000,1019577,-,-
2006,West Asia,Syria ,134,13268,6000,19402,-,-
2006,West Asia,United Arab Emirates ,430,291363,20000,311793,-,-
2006,West Asia,Yemen ,30,1239,300,1569,-,-
2006,Europe ,Europe Total,237216,270866,108354,616436,-,-
2006,Europe ,Albania ,0,5,2,7,-,-
2006,Europe ,Andorra ,0,682,50,732,-,-
2006,Europe ,Armenia ,0,20,0,20,-,-
2006,Europe ,Austria ,24094,3794,1930,29818,-,-
2006,Europe ,Azerbaijan ,300,382,500,1182,-,-
2006,Europe ,"Baltic States (Estonia, Latvia, Lithuania) ",0,30,2,32,-,-
2006,Europe ,Belorussia (Belarus) ,0,20,3,23,-,-
2006,Europe ,Belgium ,3858,3352,5600,12810,-,-
2006,Europe ,Bosnia and Herzegovina ,2,7,2,11,-,-
2006,Europe ,Bulgaria ,15,9,20,44,-,-
2006,Europe ,Channel Island ,0,1,0,1,-,-
2006,Europe ,Croatia ,9,28,3,40,-,-
2006,Europe ,Cyprus ,20,12629,3000,15649,-,-
2006,Europe ,Czech Republic ,34,103,20,157,-,-
2006,Europe ,Denmark ,5053,2721,0,7774,-,-
2006,Europe ,Finland ,1485,141,10,1636,-,-
2006,Europe ,France ,6931,964,39850,47745,-,-
2006,Europe ,Georgia ,5,64,20,89,-,-
2006,Europe ,Germany ,43706,8189,2100,53995,-,-
2006,Europe ,Gibraltar ,0,8,5,13,-,-
2006,Europe ,Greece ,91,18952,8000,27043,-,-
2006,Europe ,Greenland ,0,2,0,2,-,-
2006,Europe ,Hungary ,24,77,10,111,-,-
2006,Europe ,Iceland ,847,653,10,1510,-,-
2006,Europe ,Ireland ,100,10800,600,11500,-,-
2006,Europe ,Isle of Man ,0,43,0,43,-,-
2006,Europe ,Italy ,23108,84972,20000,128080,-,-
2006,Europe ,Liechtenstein,9,40,30,79,-,-
2006,Europe ,Luxembourg ,362,74,240,676,-,-
2006,Europe ,Macedonia ,0,50,5,55,-,-
2006,Europe ,Malta ,1,200,20,221,-,-
2006,Europe ,Moldova ,0,3,2,5,-,-
2006,Europe ,Monaco ,200,98,2900,3198,-,-
2006,Europe ,Netherlands,13635,2821,2000,18456,-,-
2006,Europe ,Norway ,16231,3060,0,19291,-,-
2006,Europe ,Poland ,47,88,40,175,-,-
2006,Europe ,Portugal ,390,329,3500,4219,-,-
2006,Europe ,Romania ,2,141,40,183,-,-
2006,Europe ,Russian Federation ,10,3000,500,3510,-,-
2006,Europe ,San Marino ,0,20,5,25,-,-
2006,Europe ,Serbia and Montenegro ,6,20,5,31,-,-
2006,Europe ,Slovak Republic ,7,25,5,37,-,-
2006,Europe ,Slovenia ,20,7,5,32,-,-
2006,Europe ,Spain ,17915,6090,2500,26505,-,-
2006,Europe ,Sweden ,7214,10119,10,17343,-,-
2006,Europe ,Switzerland ,8207,1789,2000,11996,-,-
2006,Europe ,Turkey ,667,747,3000,4414,-,-
2006,Europe ,Ukraine ,0,15,5,20,-,-
2006,Europe ,United Kingdom ,62606,93358,9600,165564,-,-
2006,Europe ,Vatican ,5,100,200,305,-,-
2006,Europe ,Yugoslavia ,0,24,5,29,-,-
2006,Americas or Trust Territories ,Americas or Trust Territories Total,2887682,203719,164635,3256036,-,-
2006,Americas or Trust Territories ,American Samoa ,50,1450,500,2000,-,-
2006,Americas or Trust Territories ,Anguilla ,0,70,5,75,-,-
2006,Americas or Trust Territories ,Antigua and Barbuda ,0,32,5,37,-,-
2006,Americas or Trust Territories ,Argentina ,49,212,20,281,-,-
2006,Americas or Trust Territories ,Aruba ,350,2203,500,3053,-,-
2006,Americas or Trust Territories ,Bahamas ,0,197,100,297,-,-
2006,Americas or Trust Territories ,Barbados ,4,62,20,86,-,-
2006,Americas or Trust Territories ,Belize ,17,80,5,102,-,-
2006,Americas or Trust Territories ,Bermuda ,0,442,100,542,-,-
2006,Americas or Trust Territories ,Bolivia ,5,8,0,13,-,-
2006,Americas or Trust Territories ,Bonaire ,0,5,0,5,-,-
2006,Americas or Trust Territories ,Brazil ,207,235,40,482,-,-
2006,Americas or Trust Territories ,British Virgin Islands ,0,20,5,25,-,-
2006,Americas or Trust Territories ,Canada ,396054,38886,3000,437940,-,-
2006,Americas or Trust Territories ,Cayman Islands ,0,997,100,1097,-,-
2006,Americas or Trust Territories ,Chile ,0,142,20,162,-,-
2006,Americas or Trust Territories ,Commonwealth of the Northern Mariana Islands,1288,12880,1400,15568,-,-
2006,Americas or Trust Territories ,Colombia ,19,13,20,52,-,-
2006,Americas or Trust Territories ,Cook Islands ,80,63,0,143,-,-
2006,Americas or Trust Territories ,Costa Rica ,31,161,10,202,-,-
2006,Americas or Trust Territories ,Cuba ,251,533,200,984,-,-
2006,Americas or Trust Territories ,Curacao ,0,25,0,25,-,-
2006,Americas or Trust Territories ,Diego Garcia ,0,1497,300,1797,-,-
2006,Americas or Trust Territories ,Dominica ,0,6,0,6,-,-
2006,Americas or Trust Territories ,Dominican Republic ,0,86,5,91,-,-
2006,Americas or Trust Territories ,Ecuador ,20,62,35,117,-,-
2006,Americas or Trust Territories ,El Salvador ,10,33,5,48,-,-
2006,Americas or Trust Territories ,Fiji ,0,140,0,140,-,-
2006,Americas or Trust Territories ,French Polynesia ,1,1000,0,1001,-,-
2006,Americas or Trust Territories ,Grenada ,0,20,0,20,-,-
2006,Americas or Trust Territories ,Guam ,45206,810,500,46516,-,-
2006,Americas or Trust Territories ,Guatemala ,74,147,20,241,-,-
2006,Americas or Trust Territories ,Guyana ,5,36,10,51,-,-
2006,Americas or Trust Territories ,Haiti ,251,9,100,360,-,-
2006,Americas or Trust Territories ,Honduras ,57,201,25,283,-,-
2006,Americas or Trust Territories ,Jamaica ,26,221,40,287,-,-
2006,Americas or Trust Territories ,Marshall Islands (Majuro) ,0,940,50,990,-,-
2006,Americas or Trust Territories ,Mexico ,21,476,100,597,-,-
2006,Americas or Trust Territories ,Federated States of Micronesia,0,1500,300,1800,-,-
2006,Americas or Trust Territories ,Netherlands Antilles,0,31,5,36,-,-
2006,Americas or Trust Territories ,Nicaragua ,14,39,5,58,-,-
2006,Americas or Trust Territories ,Palau ,21,4286,40,4347,-,-
2006,Americas or Trust Territories ,Panama ,19,101,10,130,-,-
2006,Americas or Trust Territories ,Paraguay ,15,50,5,70,-,-
2006,Americas or Trust Territories ,Peru ,46,96,10,152,-,-
2006,Americas or Trust Territories ,Puerto Rico ,10,320,0,330,-,-
2006,Americas or Trust Territories ,Solomon ,33,600,130,763,-,-
2006,Americas or Trust Territories ,Saint Kitts and Nevis,0,4,0,4,-,-
2006,Americas or Trust Territories ,Saint Lucia,0,0,0,0,-,-
2006,Americas or Trust Territories ,Saint Vincent and The Grenadines,0,24,5,29,-,-
2006,Americas or Trust Territories ,Suriname ,63,496,50,609,-,-
2006,Americas or Trust Territories ,Trinidad and Tobago ,21,282,100,403,-,-
2006,Americas or Trust Territories ,Turks and Caicos Island (West Indies),0,400,0,400,-,-
2006,Americas or Trust Territories ,United States ,2443269,128440,156500,2728209,-,-
2006,Americas or Trust Territories ,Uruguay ,0,6,10,16,-,-
2006,Americas or Trust Territories ,Vanuatu ,0,120,0,120,-,-
2006,Americas or Trust Territories ,Venezuela ,95,150,20,265,-,-
2006,Americas or Trust Territories ,US Virgin Islands,0,2085,200,2285,-,-
2006,Americas or Trust Territories ,West Indies ,0,289,5,294,-,-
2006,Oceania ,Oceania Total,238768,30167,5500,274435,-,-
2006,Oceania ,Australia ,218425,15100,3000,236525,-,-
2006,Oceania ,Kiribati ,19,310,70,399,-,-
2006,Oceania ,Nauru ,0,200,10,210,-,-
2006,Oceania ,New Caledonia ,50,2507,0,2557,-,-
2006,Oceania ,New Zealand ,19549,742,120,20411,-,-
2006,Oceania ,Palau ,5,3702,400,4107,-,-
2006,Oceania ,Papua New Guinea ,720,7505,1900,10125,-,-
2006,Oceania ,Samoa ,0,34,0,34,-,-
2006,Oceania ,Tonga ,0,60,0,60,-,-
2006,Oceania ,Tuvalu ,0,7,0,7,-,-
2006,Seabased Workers ,Seabased Workers , - ,274497,-,274497,-,-
2007,World,World Total,3693015,3413079,648169,7754263,-,-
2007,Africa ,Africa Total,1983,35498,8380,45861,-,-
2007,Africa ,Afars and Issas ,0,8,5,13,-,-
2007,Africa ,Algeria ,0,2000,500,2500,-,-
2007,Africa ,Angola ,55,2500,500,3055,-,-
2007,Africa ,Benin ,0,50,20,70,-,-
2007,Africa ,Botswana ,15,290,100,405,-,-
2007,Africa ,Burkina Faso ,0,10,20,30,-,-
2007,Africa ,Burundi ,0,10,15,25,-,-
2007,Africa ,Cameroon ,0,180,30,210,-,-
2007,Africa ,Cape Verde ,0,20,25,45,-,-
2007,Africa ,Central African Republic,0,50,20,70,-,-
2007,Africa ,Chad ,0,950,300,1250,-,-
2007,Africa ,Congo ,0,800,100,900,-,-
2007,Africa ,Congo Democratic Republic,0,5,0,5,-,-
2007,Africa ,Cote D'Ivoire (Ivory Coast) ,5,90,60,155,-,-
2007,Africa ,Djibouti ,0,400,0,400,-,-
2007,Africa ,Egypt ,877,2302,2000,5179,-,-
2007,Africa ,Equatorial Guinea ,40,5812,660,6512,-,-
2007,Africa ,Eritrea ,0,45,5,50,-,-
2007,Africa ,Ethiopia ,0,95,20,115,-,-
2007,Africa ,Gabon ,0,290,50,340,-,-
2007,Africa ,Gambia ,0,50,10,60,-,-
2007,Africa ,Ghana ,25,450,120,595,-,-
2007,Africa ,Guinea ,2,80,30,112,-,-
2007,Africa ,Guinea Bissau ,0,8,3,11,-,-
2007,Africa ,Kenya ,0,195,50,245,-,-
2007,Africa ,Lesotho ,30,250,30,310,-,-
2007,Africa ,Liberia ,20,179,10,209,-,-
2007,Africa ,Libya ,75,9490,680,10245,-,-
2007,Africa ,Madagascar ,0,162,0,162,-,-
2007,Africa ,Malawi ,0,100,10,110,-,-
2007,Africa ,Mali ,0,95,20,115,-,-
2007,Africa ,Mauritania ,0,45,0,45,-,-
2007,Africa ,Mauritius ,0,58,10,68,-,-
2007,Africa ,Morocco ,0,495,100,595,-,-
2007,Africa ,Mozambique ,35,200,50,285,-,-
2007,Africa ,Namibia ,45,799,100,944,-,-
2007,Africa ,Nigeria ,280,2455,700,3435,-,-
2007,Africa ,Rwanda ,0,19,5,24,-,-
2007,Africa ,Sao Tome and Principe ,0,20,10,30,-,-
2007,Africa ,Senegal ,5,44,10,59,-,-
2007,Africa ,Seychelles ,0,360,100,460,-,-
2007,Africa ,Sierra Leone ,6,45,2,53,-,-
2007,Africa ,Somalia ,0,5,0,5,-,-
2007,Africa ,South Africa ,150,1450,650,2250,-,-
2007,Africa ,Sudan ,290,1400,800,2490,-,-
2007,Africa ,Swaziland ,12,290,150,452,-,-
2007,Africa ,Tanzania ,0,170,50,220,-,-
2007,Africa ,Togo ,5,50,10,65,-,-
2007,Africa ,Tunisia ,0,140,20,160,-,-
2007,Africa ,Uganda ,0,140,20,160,-,-
2007,Africa ,Zambia ,5,250,150,405,-,-
2007,Africa ,Zimbabwe ,6,97,50,153,-,-
2007,East and South Asia,East and South Asia Total,213736,539578,253577,1006891,-,-
2007,East and South Asia,Afghanistan ,0,1800,395,2195,-,-
2007,East and South Asia,Bangladesh ,28,550,50,628,-,-
2007,East and South Asia,Bhutan ,0,5,2,7,-,-
2007,East and South Asia,Brunei ,50,20848,440,21338,-,-
2007,East and South Asia,Cambodia ,6,1980,1500,3486,-,-
2007,East and South Asia,China ,360,21000,4500,25860,-,-
2007,East and South Asia,Hong Kong,11471,116066,3000,130537,-,-
2007,East and South Asia,India ,181,700,500,1381,-,-
2007,East and South Asia,Indonesia ,318,10000,800,11118,-,-
2007,East and South Asia,Japan ,133528,38329,30700,202557,-,-
2007,East and South Asia,Kazakhstan,0,900,100,1000,-,-
2007,East and South Asia,North Korea,0,10,5,15,-,-
2007,East and South Asia,South Korea,6187,62528,12000,80715,-,-
2007,East and South Asia,Kyrgyzstan ,0,8,5,13,-,-
2007,East and South Asia,Laos ,2,510,30,542,-,-
2007,East and South Asia,Macau ,56,20292,3000,23348,-,-
2007,East and South Asia,Malaysia ,26002,90965,128000,244967,-,-
2007,East and South Asia,Maldives ,18,1500,800,2318,-,-
2007,East and South Asia,Mongolia ,0,55,20,75,-,-
2007,East and South Asia,Myanmar ,57,298,150,505,-,-
2007,East and South Asia,Nepal ,55,76,10,141,-,-
2007,East and South Asia,Pakistan ,151,350,1500,2001,-,-
2007,East and South Asia,Singapore ,29850,70616,56000,156466,-,-
2007,East and South Asia,Sri Lanka ,0,980,200,1180,-,-
2007,East and South Asia,Taiwan ,2357,67153,4500,74010,-,-
2007,East and South Asia,Tajikistan ,0,13,10,23,-,-
2007,East and South Asia,Thailand ,3059,8100,3600,14759,-,-
2007,East and South Asia,Timor-Leste ,0,900,400,1300,-,-
2007,East and South Asia,Turkmenistan ,0,96,50,146,-,-
2007,East and South Asia,Uzbekistan ,0,50,10,60,-,-
2007,East and South Asia,Vietnam ,0,2900,1300,4200,-,-
2007,West Asia,West Asia Total,4062,2019247,112850,2136159,-,-
2007,West Asia,Bahrain ,85,40818,3800,44703,-,-
2007,West Asia,Iran ,1016,1200,3050,5266,-,-
2007,West Asia,Iraq ,45,3379,2800,6224,-,-
2007,West Asia,Israel ,1001,29879,6000,36880,-,-
2007,West Asia,Jordan ,108,14356,8000,22464,-,-
2007,West Asia,Kuwait ,94,129708,10000,139802,-,-
2007,West Asia,Lebanon ,380,22138,3300,25818,-,-
2007,West Asia,Oman ,100,33164,9000,42264,-,-
2007,West Asia,Qatar ,15,189943,5600,195558,-,-
2007,West Asia,Saudi Arabia ,350,1046051,20000,1066401,-,-
2007,West Asia,Syria ,135,13300,6000,19435,-,-
2007,West Asia,United Arab Emirates ,703,493411,35000,529114,-,-
2007,West Asia,Yemen ,30,1900,300,2230,-,-
2007,Europe ,Europe Total,285018,291029,98074,674121,-,-
2007,Europe ,Albania ,0,10,2,12,-,-
2007,Europe ,Andorra ,0,700,50,750,-,-
2007,Europe ,Armenia ,0,20,0,20,-,-
2007,Europe ,Austria ,24252,3405,2000,29657,-,-
2007,Europe ,Azerbaijan ,308,950,500,1758,-,-
2007,Europe ,"Baltic States (Estonia, Latvia, Lithuania) ",2,30,2,34,-,-
2007,Europe ,Belorussia (Belarus) ,0,20,3,23,-,-
2007,Europe ,Belgium ,3960,3310,2500,9770,-,-
2007,Europe ,Bosnia and Herzegovina ,2,5,2,9,-,-
2007,Europe ,Bulgaria ,15,20,20,55,-,-
2007,Europe ,Channel Island ,0,1,0,1,-,-
2007,Europe ,Croatia ,9,36,3,48,-,-
2007,Europe ,Cyprus ,20,14500,3000,17520,-,-
2007,Europe ,Czech Republic ,35,120,20,175,-,-
2007,Europe ,Denmark ,6493,2733,0,9226,-,-
2007,Europe ,Finland ,1525,200,10,1735,-,-
2007,Europe ,France ,7049,1026,39000,47075,-,-
2007,Europe ,Georgia ,5,80,20,105,-,-
2007,Europe ,Germany ,44130,8106,2100,54336,-,-
2007,Europe ,Gibraltar ,0,10,5,15,-,-
2007,Europe ,Greece ,92,23252,6000,29344,-,-
2007,Europe ,Greenland ,0,2,0,2,-,-
2007,Europe ,Hungary ,26,80,10,116,-,-
2007,Europe ,Iceland ,880,700,10,1590,-,-
2007,Europe ,Ireland ,4860,11472,500,16832,-,-
2007,Europe ,Isle of Man ,0,50,0,50,-,-
2007,Europe ,Italy ,24598,82594,13000,120192,-,-
2007,Europe ,Liechtenstein,9,40,30,79,-,-
2007,Europe ,Luxembourg ,365,80,250,695,-,-
2007,Europe ,Macedonia ,0,55,5,60,-,-
2007,Europe ,Malta ,1,150,20,171,-,-
2007,Europe ,Moldova ,0,4,2,6,-,-
2007,Europe ,Monaco ,210,100,3000,3310,-,-
2007,Europe ,Netherlands,14139,3023,2000,19162,-,-
2007,Europe ,Norway ,16561,3474,0,20035,-,-
2007,Europe ,Poland ,48,100,40,188,-,-
2007,Europe ,Portugal ,395,400,3500,4295,-,-
2007,Europe ,Romania ,2,180,40,222,-,-
2007,Europe ,Russian Federation ,10,3700,500,4210,-,-
2007,Europe ,San Marino ,0,20,5,25,-,-
2007,Europe ,Serbia and Montenegro ,6,25,5,36,-,-
2007,Europe ,Slovak Republic ,7,30,5,42,-,-
2007,Europe ,Slovenia ,24,10,5,39,-,-
2007,Europe ,Spain ,27537,10543,3700,41780,-,-
2007,Europe ,Sweden ,7811,10624,0,18435,-,-
2007,Europe ,Switzerland ,8303,1739,2000,12042,-,-
2007,Europe ,Turkey ,670,776,4000,5446,-,-
2007,Europe ,Ukraine ,0,15,5,20,-,-
2007,Europe ,United Kingdom ,90654,102381,10000,203035,-,-
2007,Europe ,Vatican ,5,100,200,305,-,-
2007,Europe ,Yugoslavia ,0,28,5,33,-,-
2007,Americas or Trust Territories ,Americas or Trust Territories Total,2944289,222987,163028,3330304,-,-
2007,Americas or Trust Territories ,American Samoa ,50,1450,500,2000,-,-
2007,Americas or Trust Territories ,Anguilla ,0,70,5,75,-,-
2007,Americas or Trust Territories ,Antigua and Barbuda ,0,40,5,45,-,-
2007,Americas or Trust Territories ,Argentina ,49,200,20,269,-,-
2007,Americas or Trust Territories ,Aruba ,350,1480,500,2330,-,-
2007,Americas or Trust Territories ,Bahamas ,0,600,100,700,-,-
2007,Americas or Trust Territories ,Barbados ,4,90,20,114,-,-
2007,Americas or Trust Territories ,Belize ,17,80,5,102,-,-
2007,Americas or Trust Territories ,Bermuda ,0,800,100,900,-,-
2007,Americas or Trust Territories ,Bolivia ,5,8,0,13,-,-
2007,Americas or Trust Territories ,Bonaire ,0,5,0,5,-,-
2007,Americas or Trust Territories ,Brazil ,207,400,40,647,-,-
2007,Americas or Trust Territories ,British Virgin Islands ,0,20,5,25,-,-
2007,Americas or Trust Territories ,Canada ,410626,49309,3000,462935,-,-
2007,Americas or Trust Territories ,Cayman Islands ,0,1800,100,1900,-,-
2007,Americas or Trust Territories ,Chile ,0,130,20,150,-,-
2007,Americas or Trust Territories ,Commonwealth of the Northern Mariana Islands,1288,10979,500,12767,-,-
2007,Americas or Trust Territories ,Colombia ,19,49,20,88,-,-
2007,Americas or Trust Territories ,Cook Islands ,80,63,0,143,-,-
2007,Americas or Trust Territories ,Costa Rica ,31,160,10,201,-,-
2007,Americas or Trust Territories ,Cuba ,251,900,200,1351,-,-
2007,Americas or Trust Territories ,Curacao ,0,25,0,25,-,-
2007,Americas or Trust Territories ,Diego Garcia ,0,1000,300,1300,-,-
2007,Americas or Trust Territories ,Dominica ,0,5,0,5,-,-
2007,Americas or Trust Territories ,Dominican Republic ,0,84,5,89,-,-
2007,Americas or Trust Territories ,Ecuador ,20,70,35,125,-,-
2007,Americas or Trust Territories ,El Salvador ,10,45,5,60,-,-
2007,Americas or Trust Territories ,Fiji ,0,140,0,140,-,-
2007,Americas or Trust Territories ,French Polynesia ,1,1000,0,1001,-,-
2007,Americas or Trust Territories ,Grenada ,0,18,0,18,-,-
2007,Americas or Trust Territories ,Guam ,12675,9392,500,22567,-,-
2007,Americas or Trust Territories ,Guatemala ,74,150,20,244,-,-
2007,Americas or Trust Territories ,Guyana ,5,70,10,85,-,-
2007,Americas or Trust Territories ,Haiti ,251,120,100,471,-,-
2007,Americas or Trust Territories ,Honduras ,57,200,25,282,-,-
2007,Americas or Trust Territories ,Jamaica ,26,250,40,316,-,-
2007,Americas or Trust Territories ,Marshall Islands (Majuro) ,0,940,0,940,-,-
2007,Americas or Trust Territories ,Mexico ,23,570,100,693,-,-
2007,Americas or Trust Territories ,Federated States Of Micronesia ,0,1700,300,2000,-,-
2007,Americas or Trust Territories ,Netherlands Antilles,0,46,5,51,-,-
2007,Americas or Trust Territories ,Nicaragua ,14,40,5,59,-,-
2007,Americas or Trust Territories ,Palau ,21,4286,40,4347,-,-
2007,Americas or Trust Territories ,Panama ,19,105,10,134,-,-
2007,Americas or Trust Territories ,Paraguay ,15,50,5,70,-,-
2007,Americas or Trust Territories ,Peru ,46,100,10,156,-,-
2007,Americas or Trust Territories ,Puerto Rico ,10,320,0,330,-,-
2007,Americas or Trust Territories ,Solomon ,33,470,130,633,-,-
2007,Americas or Trust Territories ,Saint Kitts and Nevis,0,6,0,6,-,-
2007,Americas or Trust Territories ,Saint Lucia,0,0,0,0,-,-
2007,Americas or Trust Territories ,Saint Vincent and The Grenadines,0,50,5,55,-,-
2007,Americas or Trust Territories ,Suriname ,63,499,50,612,-,-
2007,Americas or Trust Territories ,Trinidad and Tobago ,21,550,100,671,-,-
2007,Americas or Trust Territories ,Turks and Caicos Island (West Indies),0,400,0,400,-,-
2007,Americas or Trust Territories ,United States ,2517833,128910,155843,2802586,-,-
2007,Americas or Trust Territories ,Uruguay ,0,20,10,30,-,-
2007,Americas or Trust Territories ,Vanuatu ,0,125,0,125,-,-
2007,Americas or Trust Territories ,Venezuela ,95,300,20,415,-,-
2007,Americas or Trust Territories ,US Virgin Islands,0,2000,200,2200,-,-
2007,Americas or Trust Territories ,West Indies ,0,298,5,303,-,-
2007,Oceania ,Oceania Total,243927,38187,12260,294374,-,-
2007,Oceania ,Australia ,221892,19455,9000,250347,-,-
2007,Oceania ,Kiribati ,22,310,90,422,-,-
2007,Oceania ,Nauru ,0,250,10,260,-,-
2007,Oceania ,New Caledonia ,50,2507,0,2557,-,-
2007,Oceania ,New Zealand ,21188,1715,120,23023,-,-
2007,Oceania ,Palau ,5,4324,400,4729,-,-
2007,Oceania ,Papua New Guinea ,770,9522,2640,12932,-,-
2007,Oceania ,Samoa ,0,34,0,34,-,-
2007,Oceania ,Tonga ,0,60,0,60,-,-
2007,Oceania ,Tuvalu ,0,10,0,10,-,-
2007,Seabased Workers ,Seabased Workers ,-,266553,-,266553,-,-
2008,World,World Total,3907842,3626259,653609,8187710,-,-
2008,Africa,Africa Total,1986,44303,8265,54554,-,-
2008,Africa,Afars and Issas ,0,10,5,15,-,-
2008,Africa,Algeria,0,2500,500,3000,-,-
2008,Africa,Angola,55,3000,500,3555,-,-
2008,Africa,Benin,0,50,20,70,-,-
2008,Africa,Botswana,15,300,100,415,-,-
2008,Africa,Burkina Faso,0,10,20,30,-,-
2008,Africa,Burundi,0,10,15,25,-,-
2008,Africa,Cameroon,0,200,30,230,-,-
2008,Africa,Cape Verde,0,20,25,45,-,-
2008,Africa,Central African Republic,0,50,20,70,-,-
2008,Africa,Chad,0,1000,300,1300,-,-
2008,Africa,Congo,0,1200,100,1300,-,-
2008,Africa,Congo Democratic Republic,0,5,0,5,-,-
2008,Africa,Cote D'Ivoire (Ivory Coast) ,5,100,60,165,-,-
2008,Africa,Djibouti,0,500,0,500,-,-
2008,Africa,Egypt,877,2314,2000,5191,-,-
2008,Africa,Equatorial Guinea,40,5890,660,6590,-,-
2008,Africa,Eritrea,0,50,5,55,-,-
2008,Africa,Ethiopia,0,100,20,120,-,-
2008,Africa,Gabon,0,300,50,350,-,-
2008,Africa,Gambia,0,50,10,60,-,-
2008,Africa,Ghana,25,541,120,686,-,-
2008,Africa,Guinea,2,100,30,132,-,-
2008,Africa,Guinea Bissau,0,8,3,11,-,-
2008,Africa,Kenya,0,200,50,250,-,-
2008,Africa,Lesotho,30,249,30,309,-,-
2008,Africa,Liberia,20,221,10,251,-,-
2008,Africa,Libya,77,16268,570,16915,-,-
2008,Africa,Madagascar,0,300,0,300,-,-
2008,Africa,Malawi,0,150,10,160,-,-
2008,Africa,Mali,0,100,20,120,-,-
2008,Africa,Mauritania,0,50,0,50,-,-
2008,Africa,Mauritius,0,58,10,68,-,-
2008,Africa,Morocco,0,500,100,600,-,-
2008,Africa,Mozambique,35,223,50,308,-,-
2008,Africa,Namibia,45,800,100,945,-,-
2008,Africa,Nigeria,281,2023,700,3004,-,-
2008,Africa,Rwanda,0,19,5,24,-,-
2008,Africa,Sao Tome and Principe,0,30,10,40,-,-
2008,Africa,Senegal,5,53,10,68,-,-
2008,Africa,Seychelles,0,400,100,500,-,-
2008,Africa,Sierra Leone,6,50,2,58,-,-
2008,Africa,Somalia,0,5,0,5,-,-
2008,Africa,South Africa,150,1500,650,2300,-,-
2008,Africa,Sudan,290,1500,800,2590,-,-
2008,Africa,Swaziland,12,300,150,462,-,-
2008,Africa,Tanzania,0,200,50,250,-,-
2008,Africa,Togo,5,50,10,65,-,-
2008,Africa,Tunisia,0,207,20,227,-,-
2008,Africa,Uganda,0,150,20,170,-,-
2008,Africa,Zambia,5,300,150,455,-,-
2008,Africa,Zimbabwe,6,100,50,156,-,-
2008,East and South Asia,East and South Asia Total,247097,581330,256622,1085049,-,-
2008,East and South Asia,Afghanistan,0,1500,395,1895,-,-
2008,East and South Asia,Bangladesh,28,600,50,678,-,-
2008,East and South Asia,Bhutan,0,5,2,7,-,-
2008,East and South Asia,Brunei Darussalam,491,19609,2100,22200,-,-
2008,East and South Asia,Cambodia,6,2000,1500,3506,-,-
2008,East and South Asia,China,360,20677,4500,25537,-,-
2008,East and South Asia,Hong Kong,23507,125810,6000,155317,-,-
2008,East and South Asia,India,182,800,500,1482,-,-
2008,East and South Asia,Indonesia,318,10500,800,11618,-,-
2008,East and South Asia,Japan,141210,60020,30700,231930,-,-
2008,East and South Asia,Kazakhstan,0,1000,100,1100,-,-
2008,East and South Asia,North Korea,0,10,5,15,-,-
2008,East and South Asia,South Korea,7669,63008,12000,82677,-,-
2008,East and South Asia,Kyrgyzstan,0,10,5,15,-,-
2008,East and South Asia,Laos,2,600,30,632,-,-
2008,East and South Asia,Macau,56,19701,3000,22757,-,-
2008,East and South Asia,Malaysia,26002,89681,128000,243683,-,-
2008,East and South Asia,Maldives,24,2095,800,2919,-,-
2008,East and South Asia,Mongolia,0,60,20,80,-,-
2008,East and South Asia,Myanmar,57,300,150,507,-,-
2008,East and South Asia,Nepal,55,77,10,142,-,-
2008,East and South Asia,Pakistan,151,400,1500,2051,-,-
2008,East and South Asia,Singapore,35820,66411,56000,158231,-,-
2008,East and South Asia,Sri Lanka,0,1000,200,1200,-,-
2008,East and South Asia,Taiwan,8100,83070,2885,94055,-,-
2008,East and South Asia,Tajikistan,0,15,10,25,-,-
2008,East and South Asia,Thailand,3059,8221,3600,14880,-,-
2008,East and South Asia,Timor-Leste,0,1000,400,1400,-,-
2008,East and South Asia,Turkmenistan,0,100,50,150,-,-
2008,East and South Asia,Uzbekistan,0,50,10,60,-,-
2008,East and South Asia,Vietnam,0,3000,1300,4300,-,-
2008,West Asia,West Asia Total,4599,2144625,112700,2261924,-,-
2008,West Asia,Bahrain,85,42659,3800,46544,-,-
2008,West Asia,Iran,1016,1500,3050,5566,-,-
2008,West Asia,Iraq,45,3370,2800,6215,-,-
2008,West Asia,Israel,1001,31000,7000,39001,-,-
2008,West Asia,Jordan,108,16500,8150,24758,-,-
2008,West Asia,Kuwait,500,136018,10000,146518,-,-
2008,West Asia,Lebanon,500,25848,5000,31348,-,-
2008,West Asia,Oman,100,34292,9000,43392,-,-
2008,West Asia,Qatar,15,224027,5600,229642,-,-
2008,West Asia,Saudi Arabia,351,1072458,20000,1092809,-,-
2008,West Asia,Syria,135,13288,6000,19423,-,-
2008,West Asia,United Arab Emirates,713,541666,32000,574379,-,-
2008,West Asia,Yemen,30,2000,300,2330,-,-
2008,Europe,Europe Total,294987,299468,98624,693079,-,-
2008,Europe,Albania,0,10,2,12,-,-
2008,Europe,Andorra,0,675,50,725,-,-
2008,Europe,Armenia,0,20,0,20,-,-
2008,Europe,Austria,24415,3276,2000,29691,-,-
2008,Europe,Azerbaijan,308,1000,500,1808,-,-
2008,Europe,"Baltic States (Estonia, Latvia, Lithuania)",2,30,2,34,-,-
2008,Europe,Belorussia (Belarus),0,19,3,22,-,-
2008,Europe,Belgium,4113,3270,2500,9883,-,-
2008,Europe,Bosnia and Herzegovina,2,5,2,9,-,-
2008,Europe,Bulgaria,15,20,20,55,-,-
2008,Europe,Channel Island,0,1,0,1,-,-
2008,Europe,Croatia,12,55,3,70,-,-
2008,Europe,Cyprus,20,15317,3000,18337,-,-
2008,Europe,Czech Republic,36,175,20,231,-,-
2008,Europe,Denmark,6538,2723,0,9261,-,-
2008,Europe,Finland,1569,278,10,1857,-,-
2008,Europe,France,7179,991,39000,47170,-,-
2008,Europe,Georgia,5,80,20,105,-,-
2008,Europe,Germany,44619,8075,2100,54794,-,-
2008,Europe,Gibraltar,0,10,5,15,-,-
2008,Europe,Greece,96,32504,6000,38600,-,-
2008,Europe,Greenland,0,7,0,7,-,-
2008,Europe,Hungary,26,81,10,117,-,-
2008,Europe,Iceland,909,703,10,1622,-,-
2008,Europe,Ireland,4981,11509,500,16990,-,-
2008,Europe,Isle of Man,0,50,0,50,-,-
2008,Europe,Italy,27003,77087,13000,117090,-,-
2008,Europe,Liechtenstein,9,40,30,79,-,-
2008,Europe,Luxembourg,365,83,250,698,-,-
2008,Europe,Macedonia,0,62,5,67,-,-
2008,Europe,Malta,1,200,20,221,-,-
2008,Europe,Moldova,0,4,2,6,-,-
2008,Europe,Monaco,210,95,3000,3305,-,-
2008,Europe,Netherlands,14337,2987,2000,19324,-,-
2008,Europe,Norway,16818,3513,0,20331,-,-
2008,Europe,Poland,48,150,40,238,-,-
2008,Europe,Portugal,399,407,3500,4306,-,-
2008,Europe,Romania,9,250,40,299,-,-
2008,Europe,Russian Federation,10,4000,700,4710,-,-
2008,Europe,San Marino,0,20,5,25,-,-
2008,Europe,Serbia and Montenegro,6,25,5,36,-,-
2008,Europe,Slovak Republic,7,30,5,42,-,-
2008,Europe,Slovenia,25,13,5,43,-,-
2008,Europe,Spain,32435,14190,4055,50680,-,-
2008,Europe,Sweden,8190,10620,0,18810,-,-
2008,Europe,Switzerland,8387,1629,2000,12016,-,-
2008,Europe,Turkey,671,773,4000,5444,-,-
2008,Europe,Ukraine,1,15,5,21,-,-
2008,Europe,United Kingdom,91206,102291,10000,203497,-,-
2008,Europe,Vatican,5,100,200,305,-,-
2008,Europe,Yugoslavia,0,38,5,43,-,-
2008,Americas or Trust Territories,Americas or Trust Territories Total,3101941,250595,166163,3518699,-,-
2008,Americas or Trust Territories,American Samoa,300,1500,500,2300,-,-
2008,Americas or Trust Territories,Anguilla,0,88,5,93,-,-
2008,Americas or Trust Territories,Antigua and Barbuda,0,50,5,55,-,-
2008,Americas or Trust Territories,Argentina,49,194,20,263,-,-
2008,Americas or Trust Territories,Aruba,350,1500,500,2350,-,-
2008,Americas or Trust Territories,Bahamas,0,700,100,800,-,-
2008,Americas or Trust Territories,Barbados,4,100,20,124,-,-
2008,Americas or Trust Territories,Belize,17,80,5,102,-,-
2008,Americas or Trust Territories,Bermuda,1,1000,100,1101,-,-
2008,Americas or Trust Territories,Bolivia,5,10,0,15,-,-
2008,Americas or Trust Territories,Brazil,207,401,40,648,-,-
2008,Americas or Trust Territories,British Virgin Islands,0,20,5,25,-,-
2008,Americas or Trust Territories,Canada,533826,73632,6135,613593,-,-
2008,Americas or Trust Territories,Cayman Islands,0,2000,100,2100,-,-
2008,Americas or Trust Territories,Chile,0,138,20,158,-,-
2008,Americas or Trust Territories,Commonwealth of the Northern Mariana Islands,1288,13000,500,14788,-,-
2008,Americas or Trust Territories,Colombia,19,50,20,89,-,-
2008,Americas or Trust Territories,Cook Islands,80,90,0,170,-,-
2008,Americas or Trust Territories,Costa Rica,31,178,10,219,-,-
2008,Americas or Trust Territories,Cuba,251,1000,200,1451,-,-
2008,Americas or Trust Territories,Diego Garcia,0,1200,300,1500,-,-
2008,Americas or Trust Territories,Dominica,0,5,0,5,-,-
2008,Americas or Trust Territories,Dominican Republic,0,82,5,87,-,-
2008,Americas or Trust Territories,Ecuador,20,68,35,123,-,-
2008,Americas or Trust Territories,El Salvador,10,48,5,63,-,-
2008,Americas or Trust Territories,Falkland Islands,1,0,0,1,-,-
2008,Americas or Trust Territories,Fiji,0,150,0,150,-,-
2008,Americas or Trust Territories,French Polynesia,0,1020,0,1020,-,-
2008,Americas or Trust Territories,Grenada,0,20,0,20,-,-
2008,Americas or Trust Territories,Guam,12675,9532,500,22707,-,-
2008,Americas or Trust Territories,Guatemala,74,146,20,240,-,-
2008,Americas or Trust Territories,Guyana,5,69,10,84,-,-
2008,Americas or Trust Territories,Haiti,251,130,100,481,-,-
2008,Americas or Trust Territories,Honduras,57,208,25,290,-,-
2008,Americas or Trust Territories,Jamaica,26,270,40,336,-,-
2008,Americas or Trust Territories,Marshall Islands (Majuro),0,1000,0,1000,-,-
2008,Americas or Trust Territories,Mexico,23,600,100,723,-,-
2008,Americas or Trust Territories,Federated States of Micronesia,0,1800,300,2100,-,-
2008,Americas or Trust Territories,Netherlands Antilles,0,50,5,55,-,-
2008,Americas or Trust Territories,Nicaragua,14,39,5,58,-,-
2008,Americas or Trust Territories,Palau,21,4500,40,4561,-,-
2008,Americas or Trust Territories,Panama,19,104,10,133,-,-
2008,Americas or Trust Territories,Paraguay,15,50,5,70,-,-
2008,Americas or Trust Territories,Peru,46,196,10,252,-,-
2008,Americas or Trust Territories,Puerto Rico,10,20,0,30,-,-
2008,Americas or Trust Territories,Solomon,33,457,130,620,-,-
2008,Americas or Trust Territories,Saint Kitts and Nevis,0,7,0,7,-,-
2008,Americas or Trust Territories,Saint Lucia,0,12,0,12,-,-
2008,Americas or Trust Territories,Saint Vincent and The Grenadines,0,50,5,55,-,-
2008,Americas or Trust Territories,Suriname,63,500,50,613,-,-
2008,Americas or Trust Territories,Trinidad and Tobago,21,685,100,806,-,-
2008,Americas or Trust Territories,Turks and Caicos Island (West Indies),0,500,0,500,-,-
2008,Americas or Trust Territories,United States ,2552034,128616,155843,2836493,-,-
2008,Americas or Trust Territories,Uruguay,0,20,10,30,-,-
2008,Americas or Trust Territories,Vanuatu,0,31,0,31,-,-
2008,Americas or Trust Territories,Venezuela,95,300,20,415,-,-
2008,Americas or Trust Territories,Virgin Islands (US),0,2079,200,2279,-,-
2008,Americas or Trust Territories,West Indies,0,300,5,305,-,-
2008,Oceania,Oceania Total,257232,44325,11235,312792,-,-
2008,Oceania,Australia,233943,23926,7975,265844,-,-
2008,Oceania,Kiribati,22,311,90,423,-,-
2008,Oceania,Nauru,0,238,10,248,-,-
2008,Oceania,New Caledonia,51,3382,0,3433,-,-
2008,Oceania,New Zealand,22440,2640,120,25200,-,-
2008,Oceania,Palau,5,4324,400,4729,-,-
2008,Oceania,Papua New Guinea,771,9380,2640,12791,-,-
2008,Oceania,Samoa,0,44,0,44,-,-
2008,Oceania,Tonga,0,70,0,70,-,-
2008,Oceania,Tuvalu,0,10,0,10,-,-
2008,Seabased Workers,Seabased Workers, - ,261614,-,261614,-,-
2009,World,World Total,4056940,3864068,658370,8579378,-,-
2009,Africa,Africa Total,2217,54389,8130,64736,-,-
2009,Africa,Afars and Issas ,0,11,5,16,-,-
2009,Africa,Algeria,0,4437,500,4937,-,-
2009,Africa,Angola,55,2000,500,2555,-,-
2009,Africa,Benin,0,51,20,71,-,-
2009,Africa,Botswana,15,319,50,384,-,-
2009,Africa,Burkina Faso,0,10,20,30,-,-
2009,Africa,Burundi,0,10,15,25,-,-
2009,Africa,Cameroon,0,204,30,234,-,-
2009,Africa,Cape Verde,0,14,25,39,-,-
2009,Africa,Central African Republic,0,49,20,69,-,-
2009,Africa,Chad,0,1101,300,1401,-,-
2009,Africa,Congo ,0,1253,100,1353,-,-
2009,Africa,Congo Democratic Republic,0,5,0,5,-,-
2009,Africa,Cote D'Ivoire (Ivory Coast) ,5,102,60,167,-,-
2009,Africa,Djibouti,0,562,0,562,-,-
2009,Africa,Egypt,1070,2653,2250,5973,-,-
2009,Africa,Equatorial Guinea,40,5756,660,6456,-,-
2009,Africa,Eritrea,0,106,5,111,-,-
2009,Africa,Ethiopia,0,99,20,119,-,-
2009,Africa,Gabon,0,308,50,358,-,-
2009,Africa,Gambia,0,50,10,60,-,-
2009,Africa,Ghana,30,600,70,700,-,-
2009,Africa,Guinea,2,118,30,150,-,-
2009,Africa,Guinea Bissau,0,8,3,11,-,-
2009,Africa,Kenya,0,204,50,254,-,-
2009,Africa,Lesotho,39,252,30,321,-,-
2009,Africa,Liberia,20,224,10,254,-,-
2009,Africa,Libya,77,23066,570,23713,-,-
2009,Africa,Madagascar,0,1082,0,1082,-,-
2009,Africa,Malawi,0,143,10,153,-,-
2009,Africa,Mali,0,130,20,150,-,-
2009,Africa,Mauritania,0,51,0,51,-,-
2009,Africa,Mauritius,0,58,10,68,-,-
2009,Africa,Morocco,0,543,100,643,-,-
2009,Africa,Mozambique,38,233,50,321,-,-
2009,Africa,Namibia,50,799,100,949,-,-
2009,Africa,Nigeria ,281,2500,700,3481,-,-
2009,Africa,Rwanda,0,20,5,25,-,-
2009,Africa,Sao Tome and Principe,0,30,10,40,-,-
2009,Africa,Senegal,5,53,10,68,-,-
2009,Africa,Seychelles,0,432,100,532,-,-
2009,Africa,Sierra Leone,6,50,2,58,-,-
2009,Africa,Somalia,0,5,0,5,-,-
2009,Africa,South Africa,151,1476,650,2277,-,-
2009,Africa,Sudan,305,1820,640,2765,-,-
2009,Africa,Swaziland,12,304,25,341,-,-
2009,Africa,Tanzania,0,216,50,266,-,-
2009,Africa,Togo,5,50,10,65,-,-
2009,Africa,Tunisia,0,234,20,254,-,-
2009,Africa,Uganda,0,182,20,202,-,-
2009,Africa,Zambia,5,327,150,482,-,-
2009,Africa,Zimbabwe,6,91,50,147,-,-
2009,East and South Asia,East and South Asia Total,262780,552524,259192,1074496,-,-
2009,East and South Asia,Afghanistan,1,1501,395,1897,-,-
2009,East and South Asia,Bangladesh,28,587,50,665,-,-
2009,East and South Asia,Bhutan,0,5,2,7,-,-
2009,East and South Asia,Brunei Darussalam,491,17472,2100,20063,-,-
2009,East and South Asia,Cambodia,22,1986,1200,3208,-,-
2009,East and South Asia,China,360,20939,4500,25799,-,-
2009,East and South Asia,Hong Kong,23508,140042,5000,168550,-,-
2009,East and South Asia,India,186,993,500,1679,-,-
2009,East and South Asia,Indonesia,344,10617,800,11761,-,-
2009,East and South Asia,Japan,146488,29559,34570,210617,-,-
2009,East and South Asia,Kazakhstan,0,1478,100,1578,-,-
2009,East and South Asia,North Korea,0,10,5,15,-,-
2009,East and South Asia,South Korea,9127,60268,12000,81395,-,-
2009,East and South Asia,Kyrgyzstan,0,10,5,15,-,-
2009,East and South Asia,Laos,2,612,30,644,-,-
2009,East and South Asia,Macau,1773,11755,3000,16528,-,-
2009,East and South Asia,Malaysia,26002,89875,128000,243877,-,-
2009,East and South Asia,Maldives,25,2856,800,3681,-,-
2009,East and South Asia,Mongolia,0,73,20,93,-,-
2009,East and South Asia,Myanmar,57,300,150,507,-,-
2009,East and South Asia,Nepal,55,77,10,142,-,-
2009,East and South Asia,Pakistan,153,595,1500,2248,-,-
2009,East and South Asia,Singapore,42770,64320,56000,163090,-,-
2009,East and South Asia,Sri Lanka,1,1000,200,1201,-,-
2009,East and South Asia,Taiwan,8328,83070,2885,94283,-,-
2009,East and South Asia,Tajikistan,0,18,10,28,-,-
2009,East and South Asia,Thailand,3059,8251,3600,14910,-,-
2009,East and South Asia,Timor-Leste,0,1093,400,1493,-,-
2009,East and South Asia,Turkmenistan,0,76,50,126,-,-
2009,East and South Asia,Uzbekistan,0,44,10,54,-,-
2009,East and South Asia,Vietnam,0,3042,1300,4342,-,-
2009,West Asia,West Asia Total,5594,2294602,115700,2415896,-,-
2009,West Asia,Bahrain,85,46610,4000,50695,-,-
2009,West Asia,Iran,1016,1404,2000,4420,-,-
2009,West Asia,Iraq,45,3370,2800,6215,-,-
2009,West Asia,Israel ,1002,31000,7000,39002,-,-
2009,West Asia,Jordan,108,16788,16000,32896,-,-
2009,West Asia,Kuwait,502,145242,10000,155744,-,-
2009,West Asia,Lebanon,500,25848,5000,31348,-,-
2009,West Asia,Oman,100,35900,5000,41000,-,-
2009,West Asia,Qatar,15,258365,5600,263980,-,-
2009,West Asia,Saudi Arabia,354,1138649,20000,1159003,-,-
2009,West Asia,Syria,135,13309,6000,19444,-,-
2009,West Asia,United Arab Emirates,1702,576002,32000,609704,-,-
2009,West Asia,Yemen,30,2116,300,2446,-,-
2009,Europe,Europe Total,312361,309914,100152,722427,-,-
2009,Europe,Albania,0,14,2,16,-,-
2009,Europe,Andorra,300,675,100,1075,-,-
2009,Europe,Armenia,0,25,0,25,-,-
2009,Europe,Austria,24555,3269,2000,29824,-,-
2009,Europe,Azerbaijan,308,1003,500,1811,-,-
2009,Europe,"Baltic States (Estonia, Latvia, Lithuania)",12,30,0,42,-,-
2009,Europe,Belorussia (Belarus),0,19,0,19,-,-
2009,Europe,Belgium,4236,240,2500,6976,-,-
2009,Europe,Bosnia and Herzegovina,2,5,0,7,-,-
2009,Europe,Bulgaria,17,21,20,58,-,-
2009,Europe,Croatia,14,78,0,92,-,-
2009,Europe,Cyprus,2484,15815,1985,20284,-,-
2009,Europe,Czech Republic,55,344,20,419,-,-
2009,Europe,Denmark,6587,2723,0,9310,-,-
2009,Europe,Finland,1616,378,10,2004,-,-
2009,Europe,France,8221,1002,40790,50013,-,-
2009,Europe,Georgia,5,190,240,435,-,-
2009,Europe,Germany,45137,8072,2100,55309,-,-
2009,Europe,Gibraltar,0,13,5,18,-,-
2009,Europe,Greece,96,45560,6000,51656,-,-
2009,Europe,Greenland,0,9,0,9,-,-
2009,Europe,Hungary,57,80,10,147,-,-
2009,Europe,Iceland,919,700,10,1629,-,-
2009,Europe,Ireland,5042,10933,500,16475,-,-
2009,Europe,Isle of Man,0,41,0,41,-,-
2009,Europe,Italy,29736,76772,13000,119508,-,-
2009,Europe,Liechtenstein,10,41,30,81,-,-
2009,Europe,Luxembourg,368,240,250,858,-,-
2009,Europe,Macedonia,0,61,0,61,-,-
2009,Europe,Malta,9,450,20,479,-,-
2009,Europe,Moldova,0,4,0,4,-,-
2009,Europe,Monaco,210,95,3000,3305,-,-
2009,Europe,Montenegro,1,0,0,1,-,-
2009,Europe,Netherlands,15363,2944,1500,19807,-,-
2009,Europe,Norway,17120,3563,0,20683,-,-
2009,Europe,Poland,53,337,40,430,-,-
2009,Europe,Portugal,404,409,3500,4313,-,-
2009,Europe,Romania,13,343,40,396,-,-
2009,Europe,Russian Federation,10,4111,700,4821,-,-
2009,Europe,San Marino,0,20,5,25,-,-
2009,Europe,Serbia,6,29,5,40,-,-
2009,Europe,Slovak Republic,12,24,5,41,-,-
2009,Europe,Slovenia,48,12,5,65,-,-
2009,Europe,Spain ,33405,13808,4055,51268,-,-
2009,Europe,Sweden,8651,10623,30,19304,-,-
2009,Europe,Switzerland,14681,4700,3050,22431,-,-
2009,Europe,Turkey,740,823,4100,5663,-,-
2009,Europe,Ukraine,1,31,5,37,-,-
2009,Europe,United Kingdom,91852,99135,10000,200987,-,-
2009,Europe,Vatican,5,100,20,125,-,-
2009,Americas or Trust Territories,Americas or Trust Territories Total,3162843,253700,166336,3582879,-,-
2009,Americas or Trust Territories,American Samoa,500,1500,500,2500,-,-
2009,Americas or Trust Territories,Anguilla,0,99,5,104,-,-
2009,Americas or Trust Territories,Antigua and Barbuda,0,50,5,55,-,-
2009,Americas or Trust Territories,Argentina,63,174,20,257,-,-
2009,Americas or Trust Territories,Aruba,360,1600,1000,2960,-,-
2009,Americas or Trust Territories,Bahamas,0,763,100,863,-,-
2009,Americas or Trust Territories,Barbados,4,50,20,74,-,-
2009,Americas or Trust Territories,Belize,17,80,5,102,-,-
2009,Americas or Trust Territories,Bermuda,1,1044,100,1145,-,-
2009,Americas or Trust Territories,Bolivia,5,10,13,28,-,-
2009,Americas or Trust Territories,Brazil,226,397,40,663,-,-
2009,Americas or Trust Territories,British Virgin Islands,0,36,5,25,-,-
2009,Americas or Trust Territories,Canada,553793,79758,6135,639686,-,-
2009,Americas or Trust Territories,Cayman Islands,0,1986,100,2086,-,-
2009,Americas or Trust Territories,Chile,3,148,20,171,-,-
2009,Americas or Trust Territories,Commonwealth of the Northern Mariana Islands,1288,15769,500,17557,-,-
2009,Americas or Trust Territories,Colombia,20,49,20,89,-,-
2009,Americas or Trust Territories,Costa Rica,119,76,10,205,-,-
2009,Americas or Trust Territories,Cuba,251,982,200,1433,-,-
2009,Americas or Trust Territories,Curacao,0,150,0,150,-,-
2009,Americas or Trust Territories,Diego Garcia,0,1188,300,1488,-,-
2009,Americas or Trust Territories,Dominica,0,5,0,5,-,-
2009,Americas or Trust Territories,Dominican Republic,1,82,5,88,-,-
2009,Americas or Trust Territories,Ecuador,65,48,35,148,-,-
2009,Americas or Trust Territories,El Salvador,10,47,5,62,-,-
2009,Americas or Trust Territories,Falkland Islands,1,0,0,1,-,-
2009,Americas or Trust Territories,French Polynesia,2,1012,0,1014,-,-
2009,Americas or Trust Territories,Grenada,0,23,0,23,-,-
2009,Americas or Trust Territories,Guam,12675,10388,500,23563,-,-
2009,Americas or Trust Territories,Guatemala,74,200,20,294,-,-
2009,Americas or Trust Territories,Guyana,7,71,10,88,-,-
2009,Americas or Trust Territories,Haiti,251,140,185,576,-,-
2009,Americas or Trust Territories,Honduras,57,206,25,288,-,-
2009,Americas or Trust Territories,Jamaica,32,280,40,352,-,-
2009,Americas or Trust Territories,Mexico,70,565,100,735,-,-
2009,Americas or Trust Territories,Netherlands Antilles,0,39,5,44,-,-
2009,Americas or Trust Territories,Nicaragua,14,55,5,74,-,-
2009,Americas or Trust Territories,Panama,19,104,10,133,-,-
2009,Americas or Trust Territories,Paraguay,15,51,5,71,-,-
2009,Americas or Trust Territories,Peru,46,235,10,291,-,-
2009,Americas or Trust Territories,Puerto Rico,10,340,0,350,-,-
2009,Americas or Trust Territories,Saint Kitts and Nevis,0,10,0,10,-,-
2009,Americas or Trust Territories,Saint Lucia,0,32,0,32,-,-
2009,Americas or Trust Territories,Saint Martin (Island),0,140,0,140,-,-
2009,Americas or Trust Territories,Saint Vincent and The Grenadines,0,51,5,56,-,-
2009,Americas or Trust Territories,Suriname,63,502,50,615,-,-
2009,Americas or Trust Territories,Trinidad and Tobago,50,1000,150,1200,-,-
2009,Americas or Trust Territories,Turks and Caicos Island (West Indies),0,562,0,562,-,-
2009,Americas or Trust Territories,United States,2592632,129191,155843,2877666,-,-
2009,Americas or Trust Territories,Uruguay,3,20,10,33,-,-
2009,Americas or Trust Territories,Venezuela,96,301,20,417,-,-
2009,Americas or Trust Territories,Virgin Islands (US),0,2091,200,2291,-,-
2009,Oceania,Oceania Total,311145,68515,8860,388520,-,-
2009,Oceania,Australia,285977,45183,4980,336140,-,-
2009,Oceania,Cook Islands,80,123,0,203,-,-
2009,Oceania,Fiji,0,600,0,600,-,-
2009,Oceania,Kiribati,22,311,90,423,-,-
2009,Oceania,Marshall Islands (Majuro),10,1024,0,1034,-,-
2009,Oceania,Federated States of Micronesia,14,1760,300,2074,-,-
2009,Oceania,Nauru,0,241,10,251,-,-
2009,Oceania,New Caledonia,52,2000,0,2052,-,-
2009,Oceania,New Zealand,24165,2854,120,27139,-,-
2009,Oceania,Palau,21,4251,400,4672,-,-
2009,Oceania,Papua New Guinea,771,9576,2830,13177,-,-
2009,Oceania,Samoa,0,50,0,50,-,-
2009,Oceania,Solomon,33,459,130,622,-,-
2009,Oceania,Tonga,0,70,0,70,-,-
2009,Oceania,Tuvalu,0,13,0,13,-,-
2009,Oceania,Vanuatu,0,131,0,131,-,-
2009,Seabased Workers,Seabased Workers,0,330424,0,330424,-,-
2010,World,World Total,4423680,4324388,704916,9452984,-,-
2010,Africa ,Africa Total,4669,62738,7076,74483,-,-
2010,Africa ,Afars and Issas ,-,7,5,12,-,-
2010,Africa ,Algeria ,0,5842,500,6342,-,-
2010,Africa ,Angola ,55,3545,500,4100,-,-
2010,Africa ,Benin ,0,51,20,71,-,-
2010,Africa ,Botswana ,125,333,50,508,-,-
2010,Africa ,Burkina Faso ,0,11,20,31,-,-
2010,Africa ,Burundi ,0,10,15,25,-,-
2010,Africa ,Cameroon ,1,190,30,221,-,-
2010,Africa ,Cape Verde ,0,15,25,40,-,-
2010,Africa ,Central African Republic,0,49,20,69,-,-
2010,Africa ,Chad ,0,1056,300,1356,-,-
2010,Africa ,Congo ,0,1094,100,1194,-,-
2010,Africa ,Congo Democratic Republic,0,180,0,180,-,-
2010,Africa ,Cote D'Ivoire (Ivory Coast) ,5,107,60,172,-,-
2010,Africa ,Djibouti ,0,616,0,616,-,-
2010,Africa ,Egypt ,1153,2932,2480,6565,-,-
2010,Africa ,Equatorial Guinea ,40,2000,46,2086,-,-
2010,Africa ,Eritrea ,0,116,5,121,-,-
2010,Africa ,Ethiopia ,0,196,20,216,-,-
2010,Africa ,Gabon ,0,308,30,338,-,-
2010,Africa ,Gambia ,0,50,10,60,-,-
2010,Africa ,Ghana ,30,950,40,1020,-,-
2010,Africa ,Guinea ,3,151,30,184,-,-
2010,Africa ,Guinea Bissau ,0,8,3,11,-,-
2010,Africa ,Kenya ,1015,207,40,1262,-,-
2010,Africa ,Lesotho ,260,70,30,360,-,-
2010,Africa ,Liberia ,20,300,25,345,-,-
2010,Africa ,Libya ,77,26772,500,27349,-,-
2010,Africa ,Madagascar ,0,4425,0,4425,-,-
2010,Africa ,Malawi ,0,140,10,150,-,-
2010,Africa ,Mali ,0,136,20,156,-,-
2010,Africa ,Mauritania ,0,52,0,52,-,-
2010,Africa ,Mauritius ,0,200,10,210,-,-
2010,Africa ,Morocco ,0,699,110,809,-,-
2010,Africa ,Mozambique ,500,644,50,1194,-,-
2010,Africa ,Namibia ,125,822,80,1027,-,-
2010,Africa ,Nigeria ,281,2136,500,2917,-,-
2010,Africa ,Rwanda ,0,145,5,150,-,-
2010,Africa ,Sao Tome and Principe ,0,30,10,40,-,-
2010,Africa ,Senegal ,5,50,10,65,-,-
2010,Africa ,Seychelles ,0,1000,100,1100,-,-
2010,Africa ,Sierra Leone ,6,87,2,95,-,-
2010,Africa ,Somalia ,0,10,0,10,-,-
2010,Africa ,South Africa ,400,1539,600,2539,-,-
2010,Africa ,Sudan ,305,1883,400,2588,-,-
2010,Africa ,Swaziland ,135,305,25,465,-,-
2010,Africa ,Tanzania ,0,222,50,272,-,-
2010,Africa ,Togo ,5,50,10,65,-,-
2010,Africa ,Tunisia ,7,241,10,258,-,-
2010,Africa ,Uganda ,0,280,20,300,-,-
2010,Africa ,Zambia ,95,386,100,581,-,-
2010,Africa ,Zimbabwe ,21,90,50,161,-,-
2010,East and South Asia,East and South Asia Total,288597,644446,299672,1232715,-,-
2010,East and South Asia,Afghanistan ,1,1000,350,1351,-,-
2010,East and South Asia,Bangladesh ,30,613,50,693,-,-
2010,East and South Asia,Bhutan ,0,5,2,7,-,-
2010,East and South Asia,Brunei Darussalam ,17657,365,2100,20122,-,-
2010,East and South Asia,Cambodia ,22,2001,1260,3283,-,-
2010,East and South Asia,China ,1844,21428,3500,26772,-,-
2010,East and South Asia,Hong Kong,23509,141240,5000,169749,-,-
2010,East and South Asia,India ,678,1103,300,2081,-,-
2010,East and South Asia,Indonesia ,344,10770,800,11914,-,-
2010,East and South Asia,Japan ,150254,127264,12840,290358,-,-
2010,East and South Asia,Kazakhstan ,0,1360,0,1360,-,-
2010,East and South Asia,North Korea,0,8,0,8,-,-
2010,East and South Asia,South Korea,10692,60267,11400,82359,-,-
2010,East and South Asia,Kyrgyzstan ,0,11,5,16,-,-
2010,East and South Asia,Laos ,2,635,30,667,-,-
2010,East and South Asia,Macau ,1773,11811,3500,17084,-,-
2010,East and South Asia,Malaysia ,26004,90269,200000,316273,-,-
2010,East and South Asia,Maldives ,25,2994,800,3819,-,-
2010,East and South Asia,Mongolia ,0,143,20,163,-,-
2010,East and South Asia,Myanmar ,57,308,150,515,-,-
2010,East and South Asia,Nepal ,55,77,10,142,-,-
2010,East and South Asia,Pakistan ,153,649,500,1302,-,-
2010,East and South Asia,Singapore ,44000,67420,48600,160020,-,-
2010,East and South Asia,Sri Lanka ,1,1011,200,1212,-,-
2010,East and South Asia,Taiwan ,8437,88077,2885,99399,-,-
2010,East and South Asia,Tajikistan ,0,15,10,25,-,-
2010,East and South Asia,Thailand ,3059,8295,3600,14954,-,-
2010,East and South Asia,Timor-Leste ,0,1369,400,1769,-,-
2010,East and South Asia,Turkmenistan ,0,93,50,143,-,-
2010,East and South Asia,Uzbekistan ,0,45,10,55,-,-
2010,East and South Asia,Vietnam ,0,3800,1300,5100,-,-
2010,West Asia,West Asia Total,5645,2717046,127900,2850591,-,-
2010,West Asia,Bahrain ,85,49775,4000,53860,-,-
2010,West Asia,Iran ,1016,909,2000,3925,-,-
2010,West Asia,Iraq ,45,3370,2800,6215,-,-
2010,West Asia,Israel ,1002,28698,6000,35700,-,-
2010,West Asia,Jordan ,108,17063,13000,30171,-,-
2010,West Asia,Kuwait ,502,160604,8000,169106,-,-
2010,West Asia,Lebanon ,501,23778,6000,30279,-,-
2010,West Asia,Oman ,140,37858,3000,40998,-,-
2010,West Asia,Qatar ,16,290315,15000,305331,-,-
2010,West Asia,Saudi Arabia ,354,1482185,30000,1512539,-,-
2010,West Asia,Syria ,135,13869,10000,24004,-,-
2010,West Asia,United Arab Emirates ,1711,606443,28000,636154,-,-
2010,West Asia,Yemen ,30,2179,100,2309,-,-
2010,Europe ,Europe Total,314710,253870,95309,663889,-,-
2010,Europe ,Albania ,0,25,2,27,-,-
2010,Europe ,Andorra ,300,675,100,1075,-,-
2010,Europe ,Armenia ,0,25,0,25,-,-
2010,Europe ,Austria ,20498,2500,1500,24498,-,-
2010,Europe ,Azerbaijan ,308,1007,500,1815,-,-
2010,Europe ,Balearic Islands ,450,900,150,1500,-,-
2010,Europe ,"Baltic States (Estonia, Latvia, Lithuania) ",12,30,0,42,-,-
2010,Europe ,Belorussia (Belarus) ,0,22,0,22,-,-
2010,Europe ,Belgium ,4362,223,2000,6585,-,-
2010,Europe ,Bosnia and Herzegovina ,3,5,0,8,-,-
2010,Europe ,Bulgaria ,24,48,20,92,-,-
2010,Europe ,Croatia ,15,78,2,95,-,-
2010,Europe ,Cyprus ,2485,16326,1985,20796,-,-
2010,Europe ,Czech Republic ,58,415,20,493,-,-
2010,Europe ,Denmark ,6628,2773,0,9401,-,-
2010,Europe ,Finland ,1680,421,10,2111,-,-
2010,Europe ,France ,8356,998,40790,50144,-,-
2010,Europe ,Georgia ,5,190,70,265,-,-
2010,Europe ,Germany ,45647,8074,2100,55821,-,-
2010,Europe ,Gibraltar ,0,16,5,21,-,-
2010,Europe ,Greece ,100,6000,5000,11100,-,-
2010,Europe ,Greenland ,1,19,0,20,-,-
2010,Europe ,Hungary ,70,83,10,163,-,-
2010,Europe ,Iceland ,938,693,10,1641,-,-
2010,Europe ,Ireland ,5118,8182,500,13800,-,-
2010,Europe ,Isle of Man ,0,40,0,40,-,-
2010,Europe ,Italy ,33055,77124,13200,123379,-,-
2010,Europe ,Liechtenstein,11,41,30,82,-,-
2010,Europe ,Luxembourg ,500,241,400,1141,-,-
2010,Europe ,Macedonia ,0,61,0,61,-,-
2010,Europe ,Malta ,9,453,20,482,-,-
2010,Europe ,Moldova ,0,6,0,6,-,-
2010,Europe ,Monaco ,210,94,1000,1304,-,-
2010,Europe ,Montenegro ,2,0,0,2,-,-
2010,Europe ,Netherlands,15574,2884,1200,19658,-,-
2010,Europe ,Norway ,17465,3689,0,21154,-,-
2010,Europe ,Poland ,68,417,40,525,-,-
2010,Europe ,Portugal ,625,1600,800,3025,-,-
2010,Europe ,Romania ,17,484,40,541,-,-
2010,Europe ,Russian Federation,10,2000,500,2510,-,-
2010,Europe ,San Marino ,0,27,5,32,-,-
2010,Europe ,Serbia ,10,29,5,44,-,-
2010,Europe ,Slovak Republic ,15,18,5,38,-,-
2010,Europe ,Slovenia ,48,24,5,77,-,-
2010,Europe ,Spain ,34098,13153,5360,52611,-,-
2010,Europe ,Sweden ,9707,2000,2000,13707,-,-
2010,Europe ,Switzerland ,12812,4717,2000,19529,-,-
2010,Europe ,Turkey ,741,837,3900,5478,-,-
2010,Europe ,Ukraine ,1,32,5,38,-,-
2010,Europe ,United Kingdom ,92669,94071,10000,196740,-,-
2010,Europe ,Vatican ,5,100,20,125,-,-
2010,Americas or Trust Territories ,Americas or Trust Territories Total,3481263,235135,166958,3883356,-,-
2010,Americas or Trust Territories ,American Samoa ,500,1500,500,2500,-,-
2010,Americas or Trust Territories ,Anguilla ,0,20,5,25,-,-
2010,Americas or Trust Territories ,Antigua and Barbuda ,0,50,5,55,-,-
2010,Americas or Trust Territories ,Argentina ,63,158,20,241,-,-
2010,Americas or Trust Territories ,Aruba ,369,1607,900,2876,-,-
2010,Americas or Trust Territories ,Bahamas ,20,638,100,758,-,-
2010,Americas or Trust Territories ,Barbados ,4,52,20,76,-,-
2010,Americas or Trust Territories ,Belize ,17,80,5,102,-,-
2010,Americas or Trust Territories ,Bermuda ,1,303,100,404,-,-
2010,Americas or Trust Territories ,Bolivia ,5,11,13,29,-,-
2010,Americas or Trust Territories ,Brazil ,235,394,50,679,-,-
2010,Americas or Trust Territories ,British Virgin Islands ,1,36,5,42,-,-
2010,Americas or Trust Territories ,Canada ,581095,80444,6135,667674,-,-
2010,Americas or Trust Territories ,Cayman Islands ,0,694,100,794,-,-
2010,Americas or Trust Territories ,Chile ,5,151,20,176,-,-
2010,Americas or Trust Territories ,Commonwealth of the Northern Mariana Islands,2500,6060,1500,10060,-,-
2010,Americas or Trust Territories ,Colombia ,22,50,20,92,-,-
2010,Americas or Trust Territories ,Costa Rica ,158,117,10,285,-,-
2010,Americas or Trust Territories ,Cuba ,125,250,100,475,-,-
2010,Americas or Trust Territories ,Curacao ,0,150,0,150,-,-
2010,Americas or Trust Territories ,Diego Garcia ,0,1170,180,1350,-,-
2010,Americas or Trust Territories ,Dominica ,0,5,0,5,-,-
2010,Americas or Trust Territories ,Dominican Republic ,53,138,5,196,-,-
2010,Americas or Trust Territories ,Ecuador ,65,50,35,150,-,-
2010,Americas or Trust Territories ,El Salvador ,14,46,5,65,-,-
2010,Americas or Trust Territories ,Falkland Islands ,1,0,0,1,-,-
2010,Americas or Trust Territories ,French Polynesia ,2,1012,0,1014,-,-
2010,Americas or Trust Territories ,Grenada ,0,23,0,23,-,-
2010,Americas or Trust Territories ,Guam ,12675,5000,500,18175,-,-
2010,Americas or Trust Territories ,Guatemala ,74,181,20,275,-,-
2010,Americas or Trust Territories ,Guyana ,7,81,10,98,-,-
2010,Americas or Trust Territories ,Haiti ,251,216,100,567,-,-
2010,Americas or Trust Territories ,Honduras ,118,93,25,236,-,-
2010,Americas or Trust Territories ,Jamaica ,35,285,40,360,-,-
2010,Americas or Trust Territories ,Mexico ,83,479,100,662,-,-
2010,Americas or Trust Territories ,Netherlands Antilles,0,62,5,67,-,-
2010,Americas or Trust Territories ,Nicaragua ,39,10,5,54,-,-
2010,Americas or Trust Territories ,Panama ,19,98,10,127,-,-
2010,Americas or Trust Territories ,Paraguay ,17,47,5,69,-,-
2010,Americas or Trust Territories ,Peru ,46,243,10,299,-,-
2010,Americas or Trust Territories ,Puerto Rico ,10,340,0,350,-,-
2010,Americas or Trust Territories ,Saba and St. Eustatius ,0,8,0,8,-,-
2010,Americas or Trust Territories ,Saint Kitts and Nevis,0,20,0,20,-,-
2010,Americas or Trust Territories ,Saint Lucia,0,33,0,33,-,-
2010,Americas or Trust Territories ,Saint Martin (Island),0,201,0,201,-,-
2010,Americas or Trust Territories ,Saint Vincent and The Grenadines,0,51,5,56,-,-
2010,Americas or Trust Territories ,Suriname ,63,100,10,173,-,-
2010,Americas or Trust Territories ,Trinidad and Tobago ,50,1022,100,1172,-,-
2010,Americas or Trust Territories ,Turks and Caicos Island (West Indies) ,0,1000,0,1000,-,-
2010,Americas or Trust Territories ,United States ,2882420,128109,156000,3166529,-,-
2010,Americas or Trust Territories ,Uruguay ,5,20,10,35,-,-
2010,Americas or Trust Territories ,Venezuela ,96,100,20,216,-,-
2010,Americas or Trust Territories ,Virgin Islands (US),0,2127,150,2277,-,-
2010,Oceania ,Oceania Total,328796,64003,8001,400800,-,-
2010,Oceania ,Australia ,302120,40007,3465,345592,-,-
2010,Oceania ,Cook Islands ,82,123,5,210,-,-
2010,Oceania ,Fiji ,164,26,10,200,-,-
2010,Oceania ,Kiribati ,22,311,5,338,-,-
2010,Oceania ,Marshall Islands (Majuro) ,14,1073,0,1087,-,-
2010,Oceania ,Federated States of Micronesia,14,1880,300,2194,-,-
2010,Oceania ,Nauru ,0,241,5,246,-,-
2010,Oceania ,New Caledonia ,100,2275,0,2375,-,-
2010,Oceania ,New Zealand ,25279,3020,1400,29699,-,-
2010,Oceania ,Niue ,8,1,1,10,-,-
2010,Oceania ,Palau (Belau) ,23,4189,400,4612,-,-
2010,Oceania ,Papua New Guinea ,773,10229,2300,13302,-,-
2010,Oceania ,Samoa ,82,13,5,100,-,-
2010,Oceania ,Solomon ,33,458,100,591,-,-
2010,Oceania ,Tonga ,82,13,5,100,-,-
2010,Oceania ,Tuvalu ,0,13,0,13,-,-
2010,Oceania ,Vanuatu ,0,131,0,131,-,-
2010,Seabased Workers ,Seabased Workers ,-,347150,-,347150,-,-
2011,World,World Total,4867645,4513171,1074972,10455788,-,-
2011,Africa,Africa Total,4933,51987,6588,63508,-,-
2011,Africa,Afars and Issas ,0,7,5,12,-,-
2011,Africa,Algeria,0,8993,250,9243,-,-
2011,Africa,Angola,225,4454,500,5179,-,-
2011,Africa,Benin,0,54,10,64,-,-
2011,Africa,Botswana,125,355,50,530,-,-
2011,Africa,Burkina Faso,0,35,15,50,-,-
2011,Africa,Burundi,0,10,15,25,-,-
2011,Africa,Cameroon,1,200,15,216,-,-
2011,Africa,Cape Verde,0,25,15,40,-,-
2011,Africa,Central African Republic,0,68,25,93,-,-
2011,Africa,Chad,0,223,75,298,-,-
2011,Africa,Congo ,0,1524,100,1624,-,-
2011,Africa,Congo Democratic Republic,0,180,0,180,-,-
2011,Africa,Cote D'Ivoire (Ivory Coast) ,5,105,60,170,-,-
2011,Africa,Djibouti,0,661,0,661,-,-
2011,Africa,Egypt,1198,3028,2570,6796,-,-
2011,Africa,Equatorial Guinea,75,3690,245,4010,-,-
2011,Africa,Eritrea,0,118,5,123,-,-
2011,Africa,Ethiopia,0,636,10,646,-,-
2011,Africa,Gabon,0,323,15,338,-,-
2011,Africa,Gambia,0,50,10,60,-,-
2011,Africa,Ghana,30,1149,70,1249,-,-
2011,Africa,Guinea,3,189,10,202,-,-
2011,Africa,Guinea Bissau,0,8,3,11,-,-
2011,Africa,Kenya,1015,257,20,1292,-,-
2011,Africa,Lesotho,260,79,30,369,-,-
2011,Africa,Liberia,20,359,25,404,-,-
2011,Africa,Libya,77,2572,75,2724,-,-
2011,Africa,Madagascar,0,5386,0,5386,-,-
2011,Africa,Malawi,0,152,10,162,-,-
2011,Africa,Mali,0,149,10,159,-,-
2011,Africa,Mauritania,0,59,0,59,-,-
2011,Africa,Mauritius,0,208,10,218,-,-
2011,Africa,Morocco,0,789,55,844,-,-
2011,Africa,Mozambique,500,796,50,1346,-,-
2011,Africa,Namibia,125,834,80,1039,-,-
2011,Africa,Nigeria ,282,6500,500,7282,-,-
2011,Africa,Rwanda,0,147,5,152,-,-
2011,Africa,Sao Tome and Principe,0,29,10,39,-,-
2011,Africa,Senegal,5,79,5,89,-,-
2011,Africa,Seychelles,0,1079,100,1179,-,-
2011,Africa,Sierra Leone,15,250,35,300,-,-
2011,Africa,Somalia,0,11,0,11,-,-
2011,Africa,South Africa,402,1784,600,2786,-,-
2011,Africa,Saint Helena (South Carolina),0,1,0,1,-,-
2011,Africa,Sudan,307,2436,635,3378,-,-
2011,Africa,Swaziland,135,318,25,478,-,-
2011,Africa,Tanzania,0,362,50,412,-,-
2011,Africa,Togo,5,60,5,70,-,-
2011,Africa,Tunisia,7,265,10,282,-,-
2011,Africa,Uganda,0,337,20,357,-,-
2011,Africa,Upper Volta,0,1,0,1,-,-
2011,Africa,Zambia,95,509,100,704,-,-
2011,Africa,Zimbabwe,21,94,50,165,-,-
2011,East and South Asia,East and South Asia Total,284646,621400,543327,1449373,-,-
2011,East and South Asia,Afghanistan,1,1000,2600,3601,-,-
2011,East and South Asia,Bangladesh,100,677,50,827,-,-
2011,East and South Asia,Bhutan,0,6,2,8,-,-
2011,East and South Asia,Brunei Darussalam,17657,1331,2100,21088,-,-
2011,East and South Asia,Cambodia,43,2187,1280,3510,-,-
2011,East and South Asia,China,1845,23380,1780,27005,-,-
2011,East and South Asia,Hong Kong,13251,156600,5000,174851,-,-
2011,East and South Asia,India,688,1310,150,2148,-,-
2011,East and South Asia,Indonesia,514,11450,465,12429,-,-
2011,East and South Asia,Japan,154219,57333,9330,220882,-,-
2011,East and South Asia,Kazakhstan,0,1513,0,1513,-,-
2011,East and South Asia,North Korea,0,25,0,25,-,-
2011,East and South Asia,South Korea,12310,63714,11860,87884,-,-
2011,East and South Asia,Kyrgyzstan,0,13,5,18,-,-
2011,East and South Asia,Laos,2,886,15,903,-,-
2011,East and South Asia,Macau,1930,12429,1935,16294,-,-
2011,East and South Asia,Malaysia,26006,95485,447590,569081,-,-
2011,East and South Asia,Maldives,25,3284,800,4109,-,-
2011,East and South Asia,Mongolia,0,438,300,738,-,-
2011,East and South Asia,Myanmar,57,360,75,492,-,-
2011,East and South Asia,Nepal,55,76,10,141,-,-
2011,East and South Asia,Pakistan,153,813,950,1916,-,-
2011,East and South Asia,Singapore,44100,86500,49400,180000,-,-
2011,East and South Asia,Sri Lanka,1,1059,100,1160,-,-
2011,East and South Asia,Taiwan,8630,83416,1850,93896,-,-
2011,East and South Asia,Tajikistan,0,16,10,26,-,-
2011,East and South Asia,Thailand,3059,9226,3600,15885,-,-
2011,East and South Asia,Timor-Leste,0,1413,710,2123,-,-
2011,East and South Asia,Turkmenistan,0,909,50,959,-,-
2011,East and South Asia,Uzbekistan,0,47,10,57,-,-
2011,East and South Asia,Vietnam,0,4504,1300,5804,-,-
2011,West Asia,West Asia Total,7713,2872440,107770,2987923,-,-
2011,West Asia,Bahrain,91,55077,3255,58423,-,-
2011,West Asia,Iran,1016,1161,505,2682,-,-
2011,West Asia,Iraq,45,3370,2800,6215,-,-
2011,West Asia,Israel ,2000,26748,6000,34748,-,-
2011,West Asia,Jordan,108,17784,11750,29642,-,-
2011,West Asia,Kuwait,502,180098,6150,186750,-,-
2011,West Asia,Lebanon,1190,21848,4500,27538,-,-
2011,West Asia,Oman,140,43318,6400,49858,-,-
2011,West Asia,Qatar,16,329426,13000,342442,-,-
2011,West Asia,Saudi Arabia,354,1530218,20000,1550572,-,-
2011,West Asia,Syria,510,2890,13600,17000,-,-
2011,West Asia,United Arab Emirates,1711,658348,19760,679819,-,-
2011,West Asia,Yemen,30,2154,50,2234,-,-
2011,Europe,Europe Total,405747,263605,139427,808779,-,-
2011,Europe,Albania,0,45,2,47,-,-
2011,Europe,Andorra,475,676,115,1266,-,-
2011,Europe,Armenia,0,29,0,29,-,-
2011,Europe,Austria,20616,2496,2000,25112,-,-
2011,Europe,Azerbaijan,308,1065,500,1873,-,-
2011,Europe,Balearic Islands,985,748,235,1968,-,-
2011,Europe,Belorussia (Belarus),0,25,0,25,-,-
2011,Europe,Belgium,6460,237,5000,11697,-,-
2011,Europe,Bosnia and Herzegovina,3,5,0,8,-,-
2011,Europe,Bulgaria,24,52,10,86,-,-
2011,Europe,Canary Island,0,1,0,1,-,-
2011,Europe,Croatia,16,80,0,96,-,-
2011,Europe,Cyprus,2707,17436,2100,22243,-,-
2011,Europe,Czech Republic,65,482,10,557,-,-
2011,Europe,Denmark,7096,3827,0,10923,-,-
2011,Europe,Estonia,1,21,0,22,-,-
2011,Europe,Finland,1767,482,10,2259,-,-
2011,Europe,France,8515,1006,41415,50936,-,-
2011,Europe,Georgia,5,194,70,269,-,-
2011,Europe,Germany,46237,8095,3030,57362,-,-
2011,Europe,Gibraltar,0,25,5,30,-,-
2011,Europe,Greece,101,46734,6000,52835,-,-
2011,Europe,Greenland,5,23,0,28,-,-
2011,Europe,Guadeloupe,0,1,0,1,-,-
2011,Europe,Guernsey,0,1,0,1,-,-
2011,Europe,Hungary,79,95,10,184,-,-
2011,Europe,Iceland,963,688,10,1661,-,-
2011,Europe,Ireland,5186,6583,3000,14769,-,-
2011,Europe,Isle of Man,0,46,0,46,-,-
2011,Europe,Italy,50001,99817,34820,184638,-,-
2011,Europe,Jersey,0,7,0,7,-,-
2011,Europe,Kosovo,0,3,0,3,-,-
2011,Europe,Latvia,6,0,0,6,-,-
2011,Europe,Liechtenstein,11,41,30,82,-,-
2011,Europe,Lithuania,2,4,0,6,-,-
2011,Europe,Luxembourg,501,247,400,1148,-,-
2011,Europe,Macedonia,0,61,0,61,-,-
2011,Europe,Malta,9,597,20,626,-,-
2011,Europe,Moldova,0,7,0,7,-,-
2011,Europe,Monaco,210,95,500,805,-,-
2011,Europe,Montenegro,2,3,0,5,-,-
2011,Europe,Netherlands,15842,2930,1500,20272,-,-
2011,Europe,Norway,17927,4770,0,22697,-,-
2011,Europe,Poland,69,431,20,520,-,-
2011,Europe,Portugal,637,1603,800,3040,-,-
2011,Europe,Romania,18,716,20,754,-,-
2011,Europe,Reunion,0,2,0,2,-,-
2011,Europe,Russian Federation,10,2204,500,2714,-,-
2011,Europe,San Marino,0,28,5,33,-,-
2011,Europe,Serbia,10,37,5,52,-,-
2011,Europe,Slovak Republic,19,22,0,41,-,-
2011,Europe,Slovenia,53,28,5,86,-,-
2011,Europe,Spain ,34969,12816,4175,51960,-,-
2011,Europe,Sweden,10108,2019,3000,15127,-,-
2011,Europe,Switzerland,12979,4767,1130,18876,-,-
2011,Europe,Turkey,744,899,3950,5593,-,-
2011,Europe,Ukraine,1,43,5,49,-,-
2011,Europe,United Kingdom,160000,35000,25000,220000,-,-
2011,Europe,Vatican,5,3210,20,3235,-,-
2011,Americas or Trust Territories,Americas or Trust Territories Total,3811111,244798,270150,4326059,-,-
2011,Americas or Trust Territories,American Samoa,500,1524,500,2524,-,-
2011,Americas or Trust Territories,Anguilla,0,21,5,26,-,-
2011,Americas or Trust Territories,Antigua and Barbuda,0,50,5,55,-,-
2011,Americas or Trust Territories,Argentina,83,163,10,256,-,-
2011,Americas or Trust Territories,Aruba,383,1616,815,2814,-,-
2011,Americas or Trust Territories,Bahamas,20,642,50,712,-,-
2011,Americas or Trust Territories,Barbados,4,58,20,82,-,-
2011,Americas or Trust Territories,Belize,17,80,5,102,-,-
2011,Americas or Trust Territories,Bermuda,1,376,100,477,-,-
2011,Americas or Trust Territories,Bolivia,5,12,10,27,-,-
2011,Americas or Trust Territories,Brazil,235,425,60,720,-,-
2011,Americas or Trust Territories,British Virgin Islands,1,294,5,300,-,-
2011,Americas or Trust Territories,Canada,735448,101908,5295,842651,-,-
2011,Americas or Trust Territories,Cayman Islands,0,2225,100,2325,-,-
2011,Americas or Trust Territories,Chile,11,159,10,180,-,-
2011,Americas or Trust Territories,Commonwealth of the Northern Mariana Islands,2500,5454,1500,9454,-,-
2011,Americas or Trust Territories,Colombia,25,56,10,91,-,-
2011,Americas or Trust Territories,Costa Rica,166,118,30,314,-,-
2011,Americas or Trust Territories,Cuba,125,110,50,285,-,-
2011,Americas or Trust Territories,Curacao,0,150,0,150,-,-
2011,Americas or Trust Territories,Diego Garcia,0,885,180,1065,-,-
2011,Americas or Trust Territories,Dominica,0,26,0,26,-,-
2011,Americas or Trust Territories,Dominican Republic,60,765,5,830,-,-
2011,Americas or Trust Territories,Ecuador,65,50,20,135,-,-
2011,Americas or Trust Territories,El Salvador,33,47,5,85,-,-
2011,Americas or Trust Territories,Falkland Islands,1,2,0,3,-,-
2011,Americas or Trust Territories,French Polynesia,3,1012,0,1015,-,-
2011,Americas or Trust Territories,Grenada,0,26,0,26,-,-
2011,Americas or Trust Territories,Guam,12680,5565,500,18745,-,-
2011,Americas or Trust Territories,Guatemala,148,181,5,334,-,-
2011,Americas or Trust Territories,Guyana,9,104,5,118,-,-
2011,Americas or Trust Territories,Haiti,251,254,50,555,-,-
2011,Americas or Trust Territories,Honduras,184,93,15,292,-,-
2011,Americas or Trust Territories,Jamaica,38,296,20,354,-,-
2011,Americas or Trust Territories,Mexico,201,510,60,771,-,-
2011,Americas or Trust Territories,Netherlands Antilles,0,46,5,51,-,-
2011,Americas or Trust Territories,Nicaragua,61,25,5,91,-,-
2011,Americas or Trust Territories,Panama,33,111,15,159,-,-
2011,Americas or Trust Territories,Paraguay,17,47,5,69,-,-
2011,Americas or Trust Territories,Peru,46,262,10,318,-,-
2011,Americas or Trust Territories,Puerto Rico,10,340,0,350,-,-
2011,Americas or Trust Territories,Saba and St. Eustatius,0,8,0,8,-,-
2011,Americas or Trust Territories,Saint Kitts and Nevis,0,22,0,22,-,-
2011,Americas or Trust Territories,Saint Lucia,0,39,0,39,-,-
2011,Americas or Trust Territories,Saint Martin (Island),0,201,0,201,-,-
2011,Americas or Trust Territories,Saint Vincent and The Grenadines,0,57,5,62,-,-
2011,Americas or Trust Territories,Suriname,63,137,5,205,-,-
2011,Americas or Trust Territories,Trinidad and Tobago,50,1069,150,1269,-,-
2011,Americas or Trust Territories,Turks and Caicos Island (West Indies),0,1900,0,1900,-,-
2011,Americas or Trust Territories,United States,3057532,112997,260335,3430864,-,-
2011,Americas or Trust Territories,Uruguay,5,25,10,40,-,-
2011,Americas or Trust Territories,Venezuela,97,130,10,237,-,-
2011,Americas or Trust Territories,Virgin Islands (US),0,2125,150,2275,-,-
2011,Oceania,Oceania Total,353495,89837,7710,451042,-,-
2011,Oceania,Australia,325089,55828,3720,384637,-,-
2011,Oceania,Cook Islands,82,171,5,258,-,-
2011,Oceania,Fiji,164,55,5,224,-,-
2011,Oceania,Kiribati,22,311,5,338,-,-
2011,Oceania,Marshall Islands (Majuro),14,1155,0,1169,-,-
2011,Oceania,Federated States of Micronesia,14,2044,150,2208,-,-
2011,Oceania,Nauru,0,243,5,248,-,-
2011,Oceania,New Caledonia,100,3541,0,3641,-,-
2011,Oceania,New Zealand,26950,7000,1225,35175,-,-
2011,Oceania,Niue,15,5,0,20,-,-
2011,Oceania,Palau (Belau),68,4345,205,4618,-,-
2011,Oceania,Papua New Guinea,780,14412,2350,17542,-,-
2011,Oceania,Samoa,82,22,5,109,-,-
2011,Oceania,Solomon,33,519,30,582,-,-
2011,Oceania,Tonga,82,22,5,109,-,-
2011,Oceania,Tuvalu,0,15,0,15,-,-
2011,Oceania,Vanuatu,0,149,0,149,-,-
2011,Seabased Workers,Seabased Workers,-,369104,-,369104,-,-
2012,World,World Total,4925797,4221041,1342790,10489628,-,-
2012,Africa,Africa Total,4641,47992,8240,60873,-,-
2012,Africa,Algeria,0,5647,0,5647,451,964
2012,Africa,Angola,225,3176,500,3901,58,985
2012,Africa,Benin,0,12,10,22,-,8
2012,Africa,Botswana,125,371,50,546,2,18
2012,Africa,Burkina Faso,0,40,15,55,-,5
2012,Africa,Burundi,0,13,5,18,0,3
2012,Africa,Cameroon,1,196,15,212,14,10
2012,Africa,Cape Verde,0,24,15,39,1,0
2012,Africa,Central African Republic,0,68,25,93,0,0
2012,Africa,Chad,0,209,75,284,903,54
2012,Africa,Congo ,0,2080,100,2180,1,557
2012,Africa,Congo Democratic Republic,0,180,0,180,-,0
2012,Africa,Cote D'Ivoire (Ivory Coast) ,5,108,140,253,-,3
2012,Africa,Djibouti,0,692,0,692,2,33
2012,Africa,Egypt,1198,3156,2760,7114,-,128
2012,Africa,Equatorial Guinea,75,4426,245,4746,278,1014
2012,Africa,Eritrea,2,233,5,240,0,115
2012,Africa,Ethiopia,2,567,10,579,0,164
2012,Africa,Gabon,0,284,15,299,55,16
2012,Africa,Gambia,0,50,10,60,-,0
2012,Africa,Ghana,30,1340,110,1480,12,203
2012,Africa,Guinea,3,223,10,236,1,35
2012,Africa,Guinea Bissau,0,8,5,13,-,0
2012,Africa,Kenya,708,287,0,995,3,33
2012,Africa,Lesotho,260,82,30,372,1,4
2012,Africa,Liberia,20,407,35,462,0,48
2012,Africa,Libya,77,2572,75,2724,-,-
2012,Africa,Madagascar,0,3320,0,3320,0,263
2012,Africa,Malawi,0,158,10,168,0,6
2012,Africa,Mali,0,154,0,154,1,6
2012,Africa,Mauritania,0,83,0,83,0,24
2012,Africa,Mauritius,0,226,10,236,1,19
2012,Africa,Morocco,6,940,1750,2696,0,151
2012,Africa,Mozambique,500,988,50,1538,0,192
2012,Africa,Namibia,125,262,80,467,578,6
2012,Africa,Nigeria ,283,6268,500,7051,440,208
2012,Africa,Rwanda,0,164,5,169,0,17
2012,Africa,Sao Tome and Principe,0,26,10,36,3,0
2012,Africa,Senegal,5,83,5,93,0,4
2012,Africa,Seychelles,0,1139,100,1239,3,63
2012,Africa,Sierra Leone,15,464,35,514,-,214
2012,Africa,Somalia,0,11,0,11,-,0
2012,Africa,South Africa,405,2025,600,3030,5,246
2012,Africa,Saint Helena (South Carolina),0,1,0,1,-,-
2012,Africa,Sudan,308,2563,575,3446,166,293
2012,Africa,Swaziland,135,333,25,493,10,25
2012,Africa,Tanzania,0,450,50,500,7,95
2012,Africa,Togo,5,60,5,70,0,0
2012,Africa,Tunisia,7,183,0,190,1,37
2012,Africa,Uganda,0,357,20,377,0,20
2012,Africa,Zambia,95,1189,100,1384,3,683
2012,Africa,Zimbabwe,21,94,50,165,0,0
2012,East and South Asia,East and South Asia Total,286627,798510,514215,1599352,114822,112641
2012,East and South Asia,Afghanistan,1,991,675,1667,10,1
2012,East and South Asia,Bangladesh,100,779,2200,3079,31,133
2012,East and South Asia,Bhutan,0,7,5,12,0,1
2012,East and South Asia,Brunei Darussalam,17658,11399,1650,30707,2846,3481
2012,East and South Asia,Cambodia,43,2267,1345,3655,9,89
2012,East and South Asia,China,1848,24725,2560,29133,92,1437
2012,East and South Asia,Hong Kong,13251,176877,5000,195128,14033,34310
2012,East and South Asia,India,360,1450,75,1885,34,174
2012,East and South Asia,Indonesia,514,11869,220,12603,87,506
2012,East and South Asia,Japan,158978,77248,6910,243136,58755,5225
2012,East and South Asia,Kazakhstan,1,1647,0,1648,105,239
2012,East and South Asia,North Korea,0,8,0,8,-,-
2012,East and South Asia,South Korea,13942,41354,13615,68911,-,-
2012,East and South Asia,Kyrgyzstan,0,13,5,18,0,0
2012,East and South Asia,Laos,2,1068,0,1070,5,187
2012,East and South Asia,Macau,1930,13553,1935,17418,0,1124
2012,East and South Asia,Malaysia,26006,212951,447590,686547,1399,12693
2012,East and South Asia,Maldives,25,3438,405,3868,17,171
2012,East and South Asia,Mongolia,0,660,300,960,0,222
2012,East and South Asia,Myanmar,76,397,0,473,1,38
2012,East and South Asia,Nepal,55,55,0,110,0,1
2012,East and South Asia,Pakistan,154,965,250,1369,4,156
2012,East and South Asia,Singapore,44102,118946,21450,184498,1947,20838
2012,East and South Asia,Sri Lanka,1,854,50,905,15,187
2012,East and South Asia,Taiwan,4521,78207,2225,84953,35352,30143
2012,East and South Asia,Tajikistan,0,9,10,19,4,3
2012,East and South Asia,Thailand,3059,9644,3600,16303,42,460
2012,East and South Asia,Timor-Leste,0,875,780,1655,-,-
2012,East and South Asia,Turkmenistan,0,1257,50,1307,0,348
2012,East and South Asia,Uzbekistan,0,47,10,57,6,0
2012,East and South Asia,Vietnam,0,4950,1300,6250,28,474
2012,West Asia,West Asia Total,7478,2449583,378475,2835536,-,-
2012,West Asia,Bahrain,91,63715,2685,66491,1890,10528
2012,West Asia,Iran,1016,1242,30,2288,108,660
2012,West Asia,Iraq,45,2040,190,2275,1341,11
2012,West Asia,Israel ,2000,25857,4500,32357,1786,895
2012,West Asia,Jordan,110,18344,12770,31224,235,795
2012,West Asia,Kuwait,502,207136,6000,213638,16150,43188
2012,West Asia,Lebanon,1198,24593,4500,30291,1698,2
2012,West Asia,Oman,140,48835,2090,51065,81,5598
2012,West Asia,Qatar,16,172000,28000,200016,6653,47078
2012,West Asia,Saudi Arabia,354,1159634,107670,1267658,51334,115289
2012,West Asia,Syria,265,1455,2760,4480,14,0
2012,West Asia,United Arab Emirates,1711,722621,207230,931562,17812,82085
2012,West Asia,Yemen,30,2111,50,2191,45,2
2012,Europe,Europe Total,392195,219816,156315,768326,-,-
2012,Europe,Albania,0,50,5,55,0,5
2012,Europe,Andorra,475,676,115,1266,0,0
2012,Europe,Armenia,0,1,0,1,-,1
2012,Europe,Austria,12930,2496,2000,17426,12,4
2012,Europe,Azerbaijan,308,30,500,838,7,37
2012,Europe,Balearic Islands,985,748,235,1968,-,-
2012,Europe,Belorussia (Belarus),0,28,0,28,0,3
2012,Europe,Belgium,6840,384,5000,12224,26,36
2012,Europe,Bosnia and Herzegovina,4,5,0,9,0,0
2012,Europe,Bulgaria,26,45,10,81,8,1
2012,Europe,Croatia,16,82,0,98,0,2
2012,Europe,Cyprus,2707,18816,2100,23623,634,2014
2012,Europe,Czech Republic,75,522,10,607,4,44
2012,Europe,Denmark,7130,3979,0,11109,4,156
2012,Europe,Estonia,24,5,0,29,-,0
2012,Europe,Finland,1870,544,0,2414,5,67
2012,Europe,France,8687,1008,42090,51785,5,7
2012,Europe,Georgia,5,196,70,271,5,7
2012,Europe,Germany,46790,8116,2080,56986,10,31
2012,Europe,Gibraltar,0,33,5,38,0,8
2012,Europe,Greece,121,26167,26000,52288,13,52
2012,Europe,Greenland,5,31,0,36,-,8
2012,Europe,Hungary,82,98,0,180,0,3
2012,Europe,Iceland,990,688,10,1688,1,1
2012,Europe,Ireland,5301,5813,3000,14114,786,16
2012,Europe,Isle of Man,0,45,0,45,1,0
2012,Europe,Italy,53819,83509,34820,172148,121,1522
2012,Europe,Latvia,8,11,0,19,-,11
2012,Europe,Liechtenstein,12,41,30,83,-,0
2012,Europe,Lithuania,2,9,0,11,-,9
2012,Europe,Luxembourg,501,174,500,1175,0,1
2012,Europe,Macedonia,0,61,0,61,0,0
2012,Europe,Malta,13,783,20,816,1,187
2012,Europe,Moldova,0,9,0,9,1,3
2012,Europe,Monaco,290,47,0,337,0,0
2012,Europe,Montenegro,2,3,0,5,-,0
2012,Europe,Netherlands,16076,3000,1500,20576,17,87
2012,Europe,Norway,18379,4997,0,23376,20,247
2012,Europe,Poland,69,438,5,512,2,9
2012,Europe,Portugal,643,1593,390,2626,17,7
2012,Europe,Romania,25,803,10,838,0,87
2012,Europe,Russian Federation,10,2386,500,2896,5,187
2012,Europe,San Marino,0,28,5,33,-,0
2012,Europe,Serbia,15,37,0,52,-,0
2012,Europe,Slovak Republic,28,18,0,46,1,1
2012,Europe,Slovenia,53,41,0,94,-,0
2012,Europe,Spain ,21380,8969,2925,33274,386,200
2012,Europe,Sweden,10556,13,2030,12599,9,22
2012,Europe,Switzerland,13177,4810,2085,20072,18,61
2012,Europe,Turkey,879,944,3260,5083,2,47
2012,Europe,Ukraine,1,70,5,76,-,27
2012,Europe,United Kingdom,160881,32896,25000,218777,2494,390
2012,Europe,Vatican,5,3520,0,3525,-,0
2012,Americas or Trust Territories,Americas or Trust Territories Total,3875930,240827,279595,4396352,-,-
2012,Americas or Trust Territories,American Samoa,500,1524,500,2524,-,-
2012,Americas or Trust Territories,Anguilla,0,24,5,29,-,3
2012,Americas or Trust Territories,Antigua and Barbuda,0,53,5,58,0,3
2012,Americas or Trust Territories,Argentina,83,102,0,185,0,7
2012,Americas or Trust Territories,Aruba,591,1527,400,2518,101,12
2012,Americas or Trust Territories,Bahamas,20,680,0,700,42,80
2012,Americas or Trust Territories,Barbados,4,58,20,82,0,0
2012,Americas or Trust Territories,Belize,17,84,0,101,9,13
2012,Americas or Trust Territories,Bermuda,1,799,100,900,41,97
2012,Americas or Trust Territories,Bolivia,6,12,0,18,-,0
2012,Americas or Trust Territories,Brazil,260,350,60,670,0,56
2012,Americas or Trust Territories,British Virgin Islands,1,294,5,300,-,-
2012,Americas or Trust Territories,Canada,759802,87304,5295,852401,1945,6132
2012,Americas or Trust Territories,Cayman Islands,0,2400,100,2500,93,214
2012,Americas or Trust Territories,Chile,11,175,10,196,0,16
2012,Americas or Trust Territories,Commonwealth of the Northern Mariana Islands,2500,5454,1050,9004,-,-
2012,Americas or Trust Territories,Colombia,25,58,5,88,0,2
2012,Americas or Trust Territories,Costa Rica,166,120,30,316,0,2
2012,Americas or Trust Territories,Cuba,65,125,25,215,230,346
2012,Americas or Trust Territories,Curacao,0,150,0,150,-,-
2012,Americas or Trust Territories,Diego Garcia,0,696,90,786,322,133
2012,Americas or Trust Territories,Dominica,0,26,0,26,0,0
2012,Americas or Trust Territories,Dominican Republic,60,385,0,445,0,5
2012,Americas or Trust Territories,Ecuador,65,50,5,120,0,0
2012,Americas or Trust Territories,El Salvador,33,29,0,62,0,1
2012,Americas or Trust Territories,Falkland Islands,1,3,0,4,-,1
2012,Americas or Trust Territories,French Polynesia,3,1012,0,1015,-,0
2012,Americas or Trust Territories,Grenada,0,26,0,26,2,2
2012,Americas or Trust Territories,Guam,13591,3390,500,17481,178,453
2012,Americas or Trust Territories,Guatemala,148,181,5,334,0,0
2012,Americas or Trust Territories,Guyana,9,117,5,131,13,26
2012,Americas or Trust Territories,Haiti,251,254,0,505,14,14
2012,Americas or Trust Territories,Honduras,184,93,15,292,0,0
2012,Americas or Trust Territories,Jamaica,38,308,5,351,6,18
2012,Americas or Trust Territories,Mexico,204,517,20,741,3,10
2012,Americas or Trust Territories,Nicaragua,61,25,0,86,0,0
2012,Americas or Trust Territories,Panama,33,78,15,126,0,10
2012,Americas or Trust Territories,Paraguay,20,47,0,67,-,0
2012,Americas or Trust Territories,Peru,46,177,5,228,0,1
2012,Americas or Trust Territories,Puerto Rico,10,340,0,350,-,0
2012,Americas or Trust Territories,Saba and St. Eustatius,0,8,0,8,-,-
2012,Americas or Trust Territories,Saint Kitts and Nevis,0,122,0,122,0,8
2012,Americas or Trust Territories,Saint Lucia,0,47,0,47,-,8
2012,Americas or Trust Territories,Saint Martin (Island),0,201,0,201,-,-
2012,Americas or Trust Territories,Saint Vincent and The Grenadines,0,74,5,79,0,17
2012,Americas or Trust Territories,Suriname,63,122,5,190,0,52
2012,Americas or Trust Territories,Trinidad and Tobago,300,189,150,639,0,18
2012,Americas or Trust Territories,Turks and Caicos Island (West Indies),0,2095,0,2095,1,-
2012,Americas or Trust Territories,United States,3096656,126625,271000,3494281,1310,701
2012,Americas or Trust Territories,Uruguay,5,13,0,18,0,0
2012,Americas or Trust Territories,Venezuela,97,156,10,263,0,26
2012,Americas or Trust Territories,Virgin Islands (US),0,2128,150,2278,2,5
2012,Oceania,Oceania Total,358926,97448,5950,462324,-,-
2012,Oceania,Australia,329348,58637,3720,391705,32,2841
2012,Oceania,Cook Islands,82,194,5,281,5,28
2012,Oceania,Fiji,164,78,5,247,8,31
2012,Oceania,Kiribati,22,165,5,192,-,-
2012,Oceania,Marshall Islands (Majuro),14,759,0,773,33,-
2012,Oceania,Federated States of Micronesia,14,2013,0,2027,31,-
2012,Oceania,Nauru,0,145,5,150,3,2
2012,Oceania,New Caledonia,101,2728,0,2829,0,594
2012,Oceania,New Zealand,28120,7771,1225,37116,24,795
2012,Oceania,Niue,15,5,0,20,-,-
2012,Oceania,Palau (Belau),68,4179,10,4257,166,-
2012,Oceania,Papua New Guinea,781,20157,950,21888,479,6224
2012,Oceania,Samoa,82,22,5,109,-,-
2012,Oceania,Solomon,33,390,15,438,8,69
2012,Oceania,Tonga,82,30,5,117,3,11
2012,Oceania,Tuvalu,0,15,0,15,-,0
2012,Oceania,Vanuatu,0,160,0,160,2,13
2012,Seabased Workers,Seabased Workers,0,366865,0,366865,-,-
